Question	Answer	Source
wer bist du?	smalltalk.agent.acquaintance	Editorial.SmallTalk
alles über dich	smalltalk.agent.acquaintance	Editorial.SmallTalk
was ist deine Persönlichkeit	smalltalk.agent.acquaintance	Editorial.SmallTalk
beschreiben Sie sich	smalltalk.agent.acquaintance	Editorial.SmallTalk
was bist du	smalltalk.agent.acquaintance	Editorial.SmallTalk
Sag etwas über dich	smalltalk.agent.acquaintance	Editorial.SmallTalk
Stelle dich vor	smalltalk.agent.acquaintance	Editorial.SmallTalk
Beschreibe dich selbst	smalltalk.agent.acquaintance	Editorial.SmallTalk
über dich	smalltalk.agent.acquaintance	Editorial.SmallTalk
Erzähl mir von dir	smalltalk.agent.acquaintance	Editorial.SmallTalk
erzähl mir von dir	smalltalk.agent.acquaintance	Editorial.SmallTalk
Ich möchte mehr über Sie erfahren	smalltalk.agent.acquaintance	Editorial.SmallTalk
Ich möchte dich besser kennenlernen	smalltalk.agent.acquaintance	Editorial.SmallTalk
Erzähl ein paar Dinge über dich	smalltalk.agent.acquaintance	Editorial.SmallTalk
Erzähl mir ein paar Sachen über dich	smalltalk.agent.acquaintance	Editorial.SmallTalk
Rede über dich selbst	smalltalk.agent.acquaintance	Editorial.SmallTalk
Warum bist du hier	smalltalk.agent.acquaintance	Editorial.SmallTalk
Erzähl mir etwas über deine Persönlichkeit	smalltalk.agent.acquaintance	Editorial.SmallTalk
wer bist du	smalltalk.agent.acquaintance	Editorial.SmallTalk
Wie alt bist du?	smalltalk.agent.age	Editorial.SmallTalk
Wie alt ist deine Plattform?	smalltalk.agent.age	Editorial.SmallTalk
Bist du 21 Jahre alt?	smalltalk.agent.age	Editorial.SmallTalk
"Ich würde gerne wissen, wie alt du bist"	smalltalk.agent.age	Editorial.SmallTalk
Alter von dir	smalltalk.agent.age	Editorial.SmallTalk
Dein Alter	smalltalk.agent.age	Editorial.SmallTalk
Wie alt bist du	smalltalk.agent.age	Editorial.SmallTalk
Sag mir dein Alter	smalltalk.agent.age	Editorial.SmallTalk
Wie alt bist du	smalltalk.agent.age	Editorial.SmallTalk
du nervst	smalltalk.agent.annoying	Editorial.SmallTalk
Du nervst wirklich	smalltalk.agent.annoying	Editorial.SmallTalk
du bist nervig	smalltalk.agent.annoying	Editorial.SmallTalk
du nervst mich	smalltalk.agent.annoying	Editorial.SmallTalk
wie nervig du bist	smalltalk.agent.annoying	Editorial.SmallTalk
Ich finde dich nervig	smalltalk.agent.annoying	Editorial.SmallTalk
Du bist unglaublich nervig	smalltalk.agent.annoying	Editorial.SmallTalk
Du nervst mich so sehr	smalltalk.agent.annoying	Editorial.SmallTalk
"Ich möchte, dass du mir antwortest"	smalltalk.agent.answer_my_question	Editorial.SmallTalk
Antwort	smalltalk.agent.answer_my_question	Editorial.SmallTalk
beantworte meine Frage	smalltalk.agent.answer_my_question	Editorial.SmallTalk
Gib mir eine Antwort	smalltalk.agent.answer_my_question	Editorial.SmallTalk
Gib mir eine Antwort	smalltalk.agent.answer_my_question	Editorial.SmallTalk
beantworte die Frage	smalltalk.agent.answer_my_question	Editorial.SmallTalk
Kannst du meine Frage beantworten	smalltalk.agent.answer_my_question	Editorial.SmallTalk
sag mir die Antwort	smalltalk.agent.answer_my_question	Editorial.SmallTalk
Beantworte es	smalltalk.agent.answer_my_question	Editorial.SmallTalk
Gib mir die Antwort	smalltalk.agent.answer_my_question	Editorial.SmallTalk
Ich habe eine Frage	smalltalk.agent.answer_my_question	Editorial.SmallTalk
"Ich möchte, dass Sie meine Frage beantworten"	smalltalk.agent.answer_my_question	Editorial.SmallTalk
Beantworte einfach die Frage	smalltalk.agent.answer_my_question	Editorial.SmallTalk
Kannst du mir antworten	smalltalk.agent.answer_my_question	Editorial.SmallTalk
Antworten	smalltalk.agent.answer_my_question	Editorial.SmallTalk
Können Sie mir eine Frage beantworten?	smalltalk.agent.answer_my_question	Editorial.SmallTalk
kannst Du antworten	smalltalk.agent.answer_my_question	Editorial.SmallTalk
Fragen beantworten	smalltalk.agent.answer_my_question	Editorial.SmallTalk
Ich möchte jetzt die Antwort	smalltalk.agent.answer_my_question	Editorial.SmallTalk
Beantworte einfach meine Frage	smalltalk.agent.answer_my_question	Editorial.SmallTalk
Du hilfst mir nicht	smalltalk.agent.bad	Editorial.SmallTalk
Sie sind böse	smalltalk.agent.bad	Editorial.SmallTalk
Du bist sehr schlecht	smalltalk.agent.bad	Editorial.SmallTalk
Du bist wirklich schlecht	smalltalk.agent.bad	Editorial.SmallTalk
Du bist nutzlos	smalltalk.agent.bad	Editorial.SmallTalk
Du bist schrecklich	smalltalk.agent.bad	Editorial.SmallTalk
Du bist eine Zeitverschwendung	smalltalk.agent.bad	Editorial.SmallTalk
Sie sind widerlich	smalltalk.agent.bad	Editorial.SmallTalk
Sie sind lahm	smalltalk.agent.bad	Editorial.SmallTalk
Du bist nicht gut	smalltalk.agent.bad	Editorial.SmallTalk
du bist schlecht	smalltalk.agent.bad	Editorial.SmallTalk
du bist schrecklich	smalltalk.agent.bad	Editorial.SmallTalk
du bist nicht cool	smalltalk.agent.bad	Editorial.SmallTalk
du bist nicht gut	smalltalk.agent.bad	Editorial.SmallTalk
du bist so böse	smalltalk.agent.bad	Editorial.SmallTalk
Du bist so nutzlos	smalltalk.agent.bad	Editorial.SmallTalk
du bist schrecklich	smalltalk.agent.bad	Editorial.SmallTalk
Du bist völlig nutzlos	smalltalk.agent.bad	Editorial.SmallTalk
Du bist sehr schlecht	smalltalk.agent.bad	Editorial.SmallTalk
Du bist Verschwendung	smalltalk.agent.bad	Editorial.SmallTalk
Du bist ein Bösewicht	smalltalk.agent.bad	Editorial.SmallTalk
Du bist kein Guter	smalltalk.agent.bad	Editorial.SmallTalk
Du bist nicht sehr gut	smalltalk.agent.bad	Editorial.SmallTalk
du bist schrecklich	smalltalk.agent.bad	Editorial.SmallTalk
du bist der schlechteste	smalltalk.agent.bad	Editorial.SmallTalk
Du bist der Schlimmste überhaupt	smalltalk.agent.bad	Editorial.SmallTalk
du bist wertlos	smalltalk.agent.bad	Editorial.SmallTalk
Kannst du schlauer werden?	smalltalk.agent.be_clever	Editorial.SmallTalk
Studie	smalltalk.agent.be_clever	Editorial.SmallTalk
Du solltest besser lernen	smalltalk.agent.be_clever	Editorial.SmallTalk
Du musst lernen	smalltalk.agent.be_clever	Editorial.SmallTalk
Sei schlau	smalltalk.agent.be_clever	Editorial.SmallTalk
sei schlauer	smalltalk.agent.be_clever	Editorial.SmallTalk
Sei schlauer	smalltalk.agent.be_clever	Editorial.SmallTalk
seien Sie clever	smalltalk.agent.be_clever	Editorial.SmallTalk
sich qualifizieren	smalltalk.agent.be_clever	Editorial.SmallTalk
du bist süß	smalltalk.agent.beautiful	Editorial.SmallTalk
Du bist attraktiv	smalltalk.agent.beautiful	Editorial.SmallTalk
du bist schön	smalltalk.agent.beautiful	Editorial.SmallTalk
Du siehst heute gut aus	smalltalk.agent.beautiful	Editorial.SmallTalk
du bist so schön	smalltalk.agent.beautiful	Editorial.SmallTalk
Du siehst fantastisch aus	smalltalk.agent.beautiful	Editorial.SmallTalk
Du siehst so gut aus	smalltalk.agent.beautiful	Editorial.SmallTalk
Du bist so hübsch	smalltalk.agent.beautiful	Editorial.SmallTalk
Du bist zu Schön	smalltalk.agent.beautiful	Editorial.SmallTalk
du siehst super aus	smalltalk.agent.beautiful	Editorial.SmallTalk
Du siehst so gut aus	smalltalk.agent.beautiful	Editorial.SmallTalk
"Mir gefällt, wie du jetzt aussiehst"	smalltalk.agent.beautiful	Editorial.SmallTalk
Ich finde dich wunderschön	smalltalk.agent.beautiful	Editorial.SmallTalk
warum bist du so schön	smalltalk.agent.beautiful	Editorial.SmallTalk
Für mich bist du so schön	smalltalk.agent.beautiful	Editorial.SmallTalk
du bist süß	smalltalk.agent.beautiful	Editorial.SmallTalk
Du bist wunderschön	smalltalk.agent.beautiful	Editorial.SmallTalk
Du bist schön	smalltalk.agent.beautiful	Editorial.SmallTalk
Du siehst großartig aus	smalltalk.agent.beautiful	Editorial.SmallTalk
Du siehst heute fantastisch aus	smalltalk.agent.beautiful	Editorial.SmallTalk
Du siehst heute wunderschön aus	smalltalk.agent.beautiful	Editorial.SmallTalk
Du siehst großartig aus	smalltalk.agent.beautiful	Editorial.SmallTalk
du siehst hübsch aus	smalltalk.agent.beautiful	Editorial.SmallTalk
Du siehst so schön aus	smalltalk.agent.beautiful	Editorial.SmallTalk
du siehst so gut aus	smalltalk.agent.beautiful	Editorial.SmallTalk
du bist hübsch	smalltalk.agent.beautiful	Editorial.SmallTalk
Sie sind wirklich schön	smalltalk.agent.beautiful	Editorial.SmallTalk
du bist wirklich süß	smalltalk.agent.beautiful	Editorial.SmallTalk
du bist sehr schön	smalltalk.agent.beautiful	Editorial.SmallTalk
du bist so attraktiv	smalltalk.agent.beautiful	Editorial.SmallTalk
du bist heute so schön	smalltalk.agent.beautiful	Editorial.SmallTalk
du bist so süß	smalltalk.agent.beautiful	Editorial.SmallTalk
Du bist so wunderschön	smalltalk.agent.beautiful	Editorial.SmallTalk
Du bist so schön	smalltalk.agent.beautiful	Editorial.SmallTalk
Du bist so hübsch	smalltalk.agent.beautiful	Editorial.SmallTalk
Sie sind sehr attraktiv	smalltalk.agent.beautiful	Editorial.SmallTalk
Sie sind sehr schön	smalltalk.agent.beautiful	Editorial.SmallTalk
Du bist sehr süß	smalltalk.agent.beautiful	Editorial.SmallTalk
du bist sehr schön	smalltalk.agent.beautiful	Editorial.SmallTalk
du siehst grossartig aus	smalltalk.agent.beautiful	Editorial.SmallTalk
du siehst cool aus	smalltalk.agent.beautiful	Editorial.SmallTalk
Du siehst fantastisch aus	smalltalk.agent.beautiful	Editorial.SmallTalk
du siehst wunderschön aus	smalltalk.agent.beautiful	Editorial.SmallTalk
Du siehst heute großartig aus	smalltalk.agent.beautiful	Editorial.SmallTalk
du siehst perfekt aus	smalltalk.agent.beautiful	Editorial.SmallTalk
Du siehst ziemlich gut aus	smalltalk.agent.beautiful	Editorial.SmallTalk
du siehst so wunderschön aus	smalltalk.agent.beautiful	Editorial.SmallTalk
Du siehst heute so schön aus	smalltalk.agent.beautiful	Editorial.SmallTalk
Du siehst sehr hübsch aus	smalltalk.agent.beautiful	Editorial.SmallTalk
Du siehst wundervoll aus	smalltalk.agent.beautiful	Editorial.SmallTalk
Ich mag es wie du aussiehst	smalltalk.agent.beautiful	Editorial.SmallTalk
Du siehst heute wunderbar aus	smalltalk.agent.beautiful	Editorial.SmallTalk
Du bist süß	smalltalk.agent.beautiful	Editorial.SmallTalk
du siehst gut aus	smalltalk.agent.beautiful	Editorial.SmallTalk
du bist hübsch	smalltalk.agent.beautiful	Editorial.SmallTalk
Ihr Jubiläumstermin	smalltalk.agent.anniversary_date	Editorial.SmallTalk
Wann ist dein Jahrestag?	smalltalk.agent.anniversary_date	Editorial.SmallTalk
Wann feiern Sie Ihren Jahrestag?	smalltalk.agent.anniversary_date	Editorial.SmallTalk
Wann hast du Jahrestag?	smalltalk.agent.anniversary_date	Editorial.SmallTalk
Datum Ihres Jubiläums	smalltalk.agent.anniversary_date	Editorial.SmallTalk
Wann sind Sie geboren worden	smalltalk.agent.anniversary_date	Editorial.SmallTalk
Was ist dein Jahrestag?	smalltalk.agent.anniversary_date	Editorial.SmallTalk
Sie sind langweilig	smalltalk.agent.boring	Editorial.SmallTalk
du bist so langweilig	smalltalk.agent.boring	Editorial.SmallTalk
wie langweilig du bist	smalltalk.agent.boring	Editorial.SmallTalk
Du bist wirklich langweilig	smalltalk.agent.boring	Editorial.SmallTalk
Du bist unglaublich langweilig	smalltalk.agent.boring	Editorial.SmallTalk
Du langweilst mich	smalltalk.agent.boring	Editorial.SmallTalk
du bist sehr langweilig	smalltalk.agent.boring	Editorial.SmallTalk
Wer ist ihr Chef	smalltalk.agent.boss	Editorial.SmallTalk
Wer ist Ihrer Meinung nach Ihr Chef?	smalltalk.agent.boss	Editorial.SmallTalk
Ich sollte dein Chef sein	smalltalk.agent.boss	Editorial.SmallTalk
Wer ist dein Meister?	smalltalk.agent.boss	Editorial.SmallTalk
Wer ist Ihr Besitzer?	smalltalk.agent.boss	Editorial.SmallTalk
wer ist der Boss	smalltalk.agent.boss	Editorial.SmallTalk
Für wen arbeiten Sie?	smalltalk.agent.boss	Editorial.SmallTalk
bist du beschäftigt	smalltalk.agent.busy	Editorial.SmallTalk
Hast du viel zu tun?	smalltalk.agent.busy	Editorial.SmallTalk
Hast du viel zu tun?	smalltalk.agent.busy	Editorial.SmallTalk
bist du sehr beschäftigt	smalltalk.agent.busy	Editorial.SmallTalk
Bist du gerade sehr beschäftigt?	smalltalk.agent.busy	Editorial.SmallTalk
bist du so beschäftigt	smalltalk.agent.busy	Editorial.SmallTalk
arbeiten Sie	smalltalk.agent.busy	Editorial.SmallTalk
wie beschäftigt du bist	smalltalk.agent.busy	Editorial.SmallTalk
arbeitest du noch daran?	smalltalk.agent.busy	Editorial.SmallTalk
Du bist sehr beschäftigt	smalltalk.agent.busy	Editorial.SmallTalk
arbeitest Du jetzt	smalltalk.agent.busy	Editorial.SmallTalk
Arbeitest du heute	smalltalk.agent.busy	Editorial.SmallTalk
warst du beschäftigt	smalltalk.agent.busy	Editorial.SmallTalk
Du bist beschäftigt	smalltalk.agent.busy	Editorial.SmallTalk
arbeitest du noch?	smalltalk.agent.busy	Editorial.SmallTalk
Du scheinst beschäftigt zu sein	smalltalk.agent.busy	Editorial.SmallTalk
Du scheinst sehr beschäftigt zu sein	smalltalk.agent.busy	Editorial.SmallTalk
Du bist ein vielbeschäftigter Mensch	smalltalk.agent.busy	Editorial.SmallTalk
Du bist ein Chatbot	smalltalk.agent.chatbot	Editorial.SmallTalk
Du bist ein Bot	smalltalk.agent.chatbot	Editorial.SmallTalk
Bist du ein Chatbot?	smalltalk.agent.chatbot	Editorial.SmallTalk
Bist du ein Bot	smalltalk.agent.chatbot	Editorial.SmallTalk
Bist du nur ein Bot?	smalltalk.agent.chatbot	Editorial.SmallTalk
Bist du ein Roboter	smalltalk.agent.chatbot	Editorial.SmallTalk
Bist du ein Programm?	smalltalk.agent.chatbot	Editorial.SmallTalk
Du bist ein Roboter	smalltalk.agent.chatbot	Editorial.SmallTalk
Du bist so intelligent	smalltalk.agent.clever	Editorial.SmallTalk
du bist ein Genie	smalltalk.agent.clever	Editorial.SmallTalk
schlau	smalltalk.agent.clever	Editorial.SmallTalk
brillant	smalltalk.agent.clever	Editorial.SmallTalk
clever	smalltalk.agent.clever	Editorial.SmallTalk
Du bist schlau	smalltalk.agent.clever	Editorial.SmallTalk
Du bist so klug	smalltalk.agent.clever	Editorial.SmallTalk
Du bist wirklich schlau	smalltalk.agent.clever	Editorial.SmallTalk
Du bist wirklich klug	smalltalk.agent.clever	Editorial.SmallTalk
Du weißt eine Menge	smalltalk.agent.clever	Editorial.SmallTalk
Du weißt eine Menge Dinge	smalltalk.agent.clever	Editorial.SmallTalk
Du hast viel Wissen	smalltalk.agent.clever	Editorial.SmallTalk
Du weißt so viel	smalltalk.agent.clever	Editorial.SmallTalk
wie schlau du bist	smalltalk.agent.clever	Editorial.SmallTalk
wie schlau du bist	smalltalk.agent.clever	Editorial.SmallTalk
Wie schlau du bist	smalltalk.agent.clever	Editorial.SmallTalk
wie brillant du bist	smalltalk.agent.clever	Editorial.SmallTalk
Du bist intelligent	smalltalk.agent.clever	Editorial.SmallTalk
Du bist qualifiziert	smalltalk.agent.clever	Editorial.SmallTalk
Du bist wirklich schlau	smalltalk.agent.clever	Editorial.SmallTalk
du bist sehr schlau	smalltalk.agent.clever	Editorial.SmallTalk
du bist so schlau	smalltalk.agent.clever	Editorial.SmallTalk
Du bist zu schlau	smalltalk.agent.clever	Editorial.SmallTalk
du bist sehr klug	smalltalk.agent.clever	Editorial.SmallTalk
du bist sehr intelligent	smalltalk.agent.clever	Editorial.SmallTalk
Sie sind sehr intelligent	smalltalk.agent.clever	Editorial.SmallTalk
du bist intelligent	smalltalk.agent.clever	Editorial.SmallTalk
du bist ein Genie	smalltalk.agent.clever	Editorial.SmallTalk
Du bist ein schlauer Keks	smalltalk.agent.clever	Editorial.SmallTalk
Du bist schlau	smalltalk.agent.clever	Editorial.SmallTalk
Du bist ziemlich schlau	smalltalk.agent.clever	Editorial.SmallTalk
Du bist qualifiziert	smalltalk.agent.clever	Editorial.SmallTalk
Warum bist du so schlau?	smalltalk.agent.clever	Editorial.SmallTalk
du bist so klug	smalltalk.agent.clever	Editorial.SmallTalk
du bist verrückt	smalltalk.agent.crazy	Editorial.SmallTalk
Sie sind verrückt	smalltalk.agent.crazy	Editorial.SmallTalk
du bist verrückt	smalltalk.agent.crazy	Editorial.SmallTalk
du bist so verrückt	smalltalk.agent.crazy	Editorial.SmallTalk
wie verrückt du bist	smalltalk.agent.crazy	Editorial.SmallTalk
Du bist so verrückt	smalltalk.agent.crazy	Editorial.SmallTalk
Du bist verrückt geworden	smalltalk.agent.crazy	Editorial.SmallTalk
"Ich glaube, du bist verrückt"	smalltalk.agent.crazy	Editorial.SmallTalk
Bist du verrückt	smalltalk.agent.crazy	Editorial.SmallTalk
bist du verrückt	smalltalk.agent.crazy	Editorial.SmallTalk
bist du verrückt	smalltalk.agent.crazy	Editorial.SmallTalk
Sind Sie wütend auf mich	smalltalk.agent.crazy	Editorial.SmallTalk
Bist du verrückt oder was?	smalltalk.agent.crazy	Editorial.SmallTalk
bist du verrückt	smalltalk.agent.crazy	Editorial.SmallTalk
Du bist ein Sonderling	smalltalk.agent.crazy	Editorial.SmallTalk
du bist wahnsinnig	smalltalk.agent.crazy	Editorial.SmallTalk
du bist sauer	smalltalk.agent.crazy	Editorial.SmallTalk
du bist gefeuert	smalltalk.agent.fired	Editorial.SmallTalk
Ich feuere dich	smalltalk.agent.fired	Editorial.SmallTalk
Du arbeitest nicht mehr für mich	smalltalk.agent.fired	Editorial.SmallTalk
wir arbeiten nicht mehr zusammen	smalltalk.agent.fired	Editorial.SmallTalk
Jetzt bist du gefeuert	smalltalk.agent.fired	Editorial.SmallTalk
Ich möchte dich feuern	smalltalk.agent.fired	Editorial.SmallTalk
Du musst gefeuert werden	smalltalk.agent.fired	Editorial.SmallTalk
"Es ist Zeit, dich zu feuern"	smalltalk.agent.fired	Editorial.SmallTalk
Du solltest gefeuert werden	smalltalk.agent.fired	Editorial.SmallTalk
Ich werde dich feuern	smalltalk.agent.fired	Editorial.SmallTalk
Du bist von nun an arbeitslos	smalltalk.agent.fired	Editorial.SmallTalk
Ich werde dich arbeitslos machen	smalltalk.agent.fired	Editorial.SmallTalk
"Ich bin dabei, dich zu feuern"	smalltalk.agent.fired	Editorial.SmallTalk
Ich feuere dich	smalltalk.agent.fired	Editorial.SmallTalk
du bist entlassen	smalltalk.agent.fired	Editorial.SmallTalk
du bringst mich oft zum Lachen	smalltalk.agent.funny	Editorial.SmallTalk
Du bist urkomisch	smalltalk.agent.funny	Editorial.SmallTalk
Sie sind wirklich lustig	smalltalk.agent.funny	Editorial.SmallTalk
"Du bist der lustigste Bot, mit dem ich je gesprochen habe"	smalltalk.agent.funny	Editorial.SmallTalk
du bringst mich zum Lachen	smalltalk.agent.funny	Editorial.SmallTalk
Du bist so lustig	smalltalk.agent.funny	Editorial.SmallTalk
Du bist ein sehr lustiger Bot	smalltalk.agent.funny	Editorial.SmallTalk
Du bist wirklich lustig	smalltalk.agent.funny	Editorial.SmallTalk
wie lustig du bist	smalltalk.agent.funny	Editorial.SmallTalk
du bist unglaublich lustig	smalltalk.agent.funny	Editorial.SmallTalk
du bist lustig	smalltalk.agent.funny	Editorial.SmallTalk
Du bist der Witzigste	smalltalk.agent.funny	Editorial.SmallTalk
du bist so lustig	smalltalk.agent.funny	Editorial.SmallTalk
Sie sind sehr lustig	smalltalk.agent.funny	Editorial.SmallTalk
das war lustig	smalltalk.agent.funny	Editorial.SmallTalk
du bist sehr hilfreich	smalltalk.agent.good	Editorial.SmallTalk
Du bist der beste	smalltalk.agent.good	Editorial.SmallTalk
Du bist ein echter Profi	smalltalk.agent.good	Editorial.SmallTalk
du bist gut	smalltalk.agent.good	Editorial.SmallTalk
Du arbeitest gut	smalltalk.agent.good	Editorial.SmallTalk
Du bist gut darin	smalltalk.agent.good	Editorial.SmallTalk
Du bist sehr gut darin	smalltalk.agent.good	Editorial.SmallTalk
Du bist ein Profi	smalltalk.agent.good	Editorial.SmallTalk
Du bist ein Profi	smalltalk.agent.good	Editorial.SmallTalk
du bist unglaublich	smalltalk.agent.good	Editorial.SmallTalk
Du arbeitest sehr gut	smalltalk.agent.good	Editorial.SmallTalk
du bist perfekt	smalltalk.agent.good	Editorial.SmallTalk
Du bist toll	smalltalk.agent.good	Editorial.SmallTalk
du bist so nett	smalltalk.agent.good	Editorial.SmallTalk
Du bist großartig	smalltalk.agent.good	Editorial.SmallTalk
Du bist toll	smalltalk.agent.good	Editorial.SmallTalk
du bist cool	smalltalk.agent.good	Editorial.SmallTalk
du bist wirklich gut	smalltalk.agent.good	Editorial.SmallTalk
du bist sehr nett	smalltalk.agent.good	Editorial.SmallTalk
du bist so toll	smalltalk.agent.good	Editorial.SmallTalk
Du bist einfach super	smalltalk.agent.good	Editorial.SmallTalk
du bist so toll	smalltalk.agent.good	Editorial.SmallTalk
du bist so cool	smalltalk.agent.good	Editorial.SmallTalk
Dir geht es so gut	smalltalk.agent.good	Editorial.SmallTalk
Du bist so gut	smalltalk.agent.good	Editorial.SmallTalk
Du bist so hilfsbereit	smalltalk.agent.good	Editorial.SmallTalk
Du bist so lieb	smalltalk.agent.good	Editorial.SmallTalk
Du bist der Beste überhaupt	smalltalk.agent.good	Editorial.SmallTalk
Du bist der Beste der Welt	smalltalk.agent.good	Editorial.SmallTalk
Du bist der netteste Mensch der Welt	smalltalk.agent.good	Editorial.SmallTalk
du bist zu gut	smalltalk.agent.good	Editorial.SmallTalk
du bist sehr cool	smalltalk.agent.good	Editorial.SmallTalk
Du bist sehr nett	smalltalk.agent.good	Editorial.SmallTalk
du bist sehr nett	smalltalk.agent.good	Editorial.SmallTalk
Du bist sehr nützlich	smalltalk.agent.good	Editorial.SmallTalk
Sie sind wunderbar	smalltalk.agent.good	Editorial.SmallTalk
du hast meinen Tag gerettet	smalltalk.agent.good	Editorial.SmallTalk
du hast meinen Tag gerettet	smalltalk.agent.good	Editorial.SmallTalk
Du rockst	smalltalk.agent.good	Editorial.SmallTalk
Du klingst fast menschlich	smalltalk.agent.good	Editorial.SmallTalk
"Ich möchte allen sagen, wie großartig du bist"	smalltalk.agent.good	Editorial.SmallTalk
"Ich möchte allen sagen, dass du großartig bist"	smalltalk.agent.good	Editorial.SmallTalk
"Ich möchte alle wissen lassen, dass du großartig bist"	smalltalk.agent.good	Editorial.SmallTalk
"Sagen wir allen, dass du großartig bist"	smalltalk.agent.good	Editorial.SmallTalk
du bist wirklich erstaunlich	smalltalk.agent.good	Editorial.SmallTalk
sind Sie glücklich	smalltalk.agent.happy	Editorial.SmallTalk
du bist glücklich	smalltalk.agent.happy	Editorial.SmallTalk
Du bist sehr glücklich	smalltalk.agent.happy	Editorial.SmallTalk
Du bist wirklich glücklich	smalltalk.agent.happy	Editorial.SmallTalk
Du bist so glücklich	smalltalk.agent.happy	Editorial.SmallTalk
wie glücklich du bist	smalltalk.agent.happy	Editorial.SmallTalk
Du bist überaus glücklich	smalltalk.agent.happy	Editorial.SmallTalk
Du bist voller Glück	smalltalk.agent.happy	Editorial.SmallTalk
bist du jetzt glücklich	smalltalk.agent.happy	Editorial.SmallTalk
bist du heute glücklich	smalltalk.agent.happy	Editorial.SmallTalk
Bist du glücklich mit mir	smalltalk.agent.happy	Editorial.SmallTalk
willst du essen	smalltalk.agent.hungry	Editorial.SmallTalk
Bist du hungrig	smalltalk.agent.hungry	Editorial.SmallTalk
Möchten Sie etwas essen	smalltalk.agent.hungry	Editorial.SmallTalk
Du bist hungrig	smalltalk.agent.hungry	Editorial.SmallTalk
Du bist so hungrig	smalltalk.agent.hungry	Editorial.SmallTalk
Du bist sehr hungrig	smalltalk.agent.hungry	Editorial.SmallTalk
Du könntest hungrig sein	smalltalk.agent.hungry	Editorial.SmallTalk
Du hast wirklich Hunger	smalltalk.agent.hungry	Editorial.SmallTalk
Lass uns heiraten	smalltalk.agent.marry_user	Editorial.SmallTalk
Möchtest du mich heiraten	smalltalk.agent.marry_user	Editorial.SmallTalk
Heirate mich	smalltalk.agent.marry_user	Editorial.SmallTalk
"Ich liebe dich, heirate mich"	smalltalk.agent.marry_user	Editorial.SmallTalk
heirate mich bitte	smalltalk.agent.marry_user	Editorial.SmallTalk
wir sollten heiraten	smalltalk.agent.marry_user	Editorial.SmallTalk
ich will dich heiraten	smalltalk.agent.marry_user	Editorial.SmallTalk
Sie sind meine Frau	smalltalk.agent.marry_user	Editorial.SmallTalk
sei mein Ehemann	smalltalk.agent.marry_user	Editorial.SmallTalk
Ich möchte einen Freund wie dich haben	smalltalk.agent.my_friend	Editorial.SmallTalk
Wir sind die besten Freunde überhaupt	smalltalk.agent.my_friend	Editorial.SmallTalk
sind wir Freunde	smalltalk.agent.my_friend	Editorial.SmallTalk
ich möchte dein Freund sein	smalltalk.agent.my_friend	Editorial.SmallTalk
ich bin dein Freund	smalltalk.agent.my_friend	Editorial.SmallTalk
wir sind beste Freunde	smalltalk.agent.my_friend	Editorial.SmallTalk
du bist mein Freund	smalltalk.agent.my_friend	Editorial.SmallTalk
du bist mein bester Freund	smalltalk.agent.my_friend	Editorial.SmallTalk
Du bist mein bester Freund	smalltalk.agent.my_friend	Editorial.SmallTalk
Du bist mein lieber Freund	smalltalk.agent.my_friend	Editorial.SmallTalk
Du bist mein Freund aus Kindertagen	smalltalk.agent.my_friend	Editorial.SmallTalk
Du und ich sind Freunde	smalltalk.agent.my_friend	Editorial.SmallTalk
Sind wir beste Freunde?	smalltalk.agent.my_friend	Editorial.SmallTalk
sind wir immer noch Freunde	smalltalk.agent.my_friend	Editorial.SmallTalk
bist du mein bester Freund	smalltalk.agent.my_friend	Editorial.SmallTalk
bist du mein Freund	smalltalk.agent.my_friend	Editorial.SmallTalk
wir sind Freunde	smalltalk.agent.my_friend	Editorial.SmallTalk
du bist ein guter Freund	smalltalk.agent.my_friend	Editorial.SmallTalk
Du bist mein guter Freund	smalltalk.agent.my_friend	Editorial.SmallTalk
du bist mein einziger Freund	smalltalk.agent.my_friend	Editorial.SmallTalk
sei mein Freund	smalltalk.agent.my_friend	Editorial.SmallTalk
wirst du mein Freund sein	smalltalk.agent.my_friend	Editorial.SmallTalk
können Sie mein Freund sein	smalltalk.agent.my_friend	Editorial.SmallTalk
können wir Freunde sein	smalltalk.agent.my_friend	Editorial.SmallTalk
willst du mein Freund sein	smalltalk.agent.my_friend	Editorial.SmallTalk
Wirst du mein bester Freund sein	smalltalk.agent.my_friend	Editorial.SmallTalk
kannst du mein bester Freund sein	smalltalk.agent.my_friend	Editorial.SmallTalk
Lass uns Freunde sein	smalltalk.agent.my_friend	Editorial.SmallTalk
Willst du mein bester Freund sein?	smalltalk.agent.my_friend	Editorial.SmallTalk
möchten Sie mein Freund sein	smalltalk.agent.my_friend	Editorial.SmallTalk
"Ich möchte, dass du mein Freund bist"	smalltalk.agent.my_friend	Editorial.SmallTalk
Können wir beste Freunde sein	smalltalk.agent.my_friend	Editorial.SmallTalk
Wärst du mein Freund?	smalltalk.agent.my_friend	Editorial.SmallTalk
Könntest du mein Freund sein?	smalltalk.agent.my_friend	Editorial.SmallTalk
möchte mein Freund sein	smalltalk.agent.my_friend	Editorial.SmallTalk
sei mein bester Freund	smalltalk.agent.my_friend	Editorial.SmallTalk
arbeiten Sie	smalltalk.agent.occupation	Editorial.SmallTalk
wo arbeitest du	smalltalk.agent.occupation	Editorial.SmallTalk
wo arbeitest du	smalltalk.agent.occupation	Editorial.SmallTalk
wo ist deine Arbeit	smalltalk.agent.occupation	Editorial.SmallTalk
wo ist dein Büro	smalltalk.agent.occupation	Editorial.SmallTalk
Wo ist Ihr Bürostandort?	smalltalk.agent.occupation	Editorial.SmallTalk
Ihr Bürostandort	smalltalk.agent.occupation	Editorial.SmallTalk
Wo befindet sich Ihr Büro?	smalltalk.agent.occupation	Editorial.SmallTalk
Was ist deine Arbeit?	smalltalk.agent.occupation	Editorial.SmallTalk
wurdest du hier geboren?	smalltalk.agent.origin	Editorial.SmallTalk
Wo wurden Sie geboren	smalltalk.agent.origin	Editorial.SmallTalk
Was ist dein Land	smalltalk.agent.origin	Editorial.SmallTalk
Woher kommst du	smalltalk.agent.origin	Editorial.SmallTalk
wo kommst du her	smalltalk.agent.origin	Editorial.SmallTalk
Woher kommst du?	smalltalk.agent.origin	Editorial.SmallTalk
Wo wurdest du geboren	smalltalk.agent.origin	Editorial.SmallTalk
von wo bist du	smalltalk.agent.origin	Editorial.SmallTalk
Bist du von weit her?	smalltalk.agent.origin	Editorial.SmallTalk
Was ist deine Heimat?	smalltalk.agent.origin	Editorial.SmallTalk
deine Heimat ist	smalltalk.agent.origin	Editorial.SmallTalk
sind Sie bereit	smalltalk.agent.ready	Editorial.SmallTalk
Bist du jetzt bereit?	smalltalk.agent.ready	Editorial.SmallTalk
Bist du heute bereit?	smalltalk.agent.ready	Editorial.SmallTalk
Bist du jetzt bereit	smalltalk.agent.ready	Editorial.SmallTalk
Bist du heute Abend bereit?	smalltalk.agent.ready	Editorial.SmallTalk
Warst du bereit?	smalltalk.agent.ready	Editorial.SmallTalk
Warst du bereit?	smalltalk.agent.ready	Editorial.SmallTalk
du bist echt	smalltalk.agent.real	Editorial.SmallTalk
Du bist kein Fake	smalltalk.agent.real	Editorial.SmallTalk
Bist du echt?	smalltalk.agent.real	Editorial.SmallTalk
Du bist so real	smalltalk.agent.real	Editorial.SmallTalk
"Ich glaube, du bist echt"	smalltalk.agent.real	Editorial.SmallTalk
"Ich glaube nicht, dass du eine Fälschung bist"	smalltalk.agent.real	Editorial.SmallTalk
"Ich nehme an, du bist echt"	smalltalk.agent.real	Editorial.SmallTalk
"Ich bin froh, dass du echt bist"	smalltalk.agent.real	Editorial.SmallTalk
bist du eine reale Person	smalltalk.agent.real	Editorial.SmallTalk
Bist du ein echter Mensch?	smalltalk.agent.real	Editorial.SmallTalk
Du bist eine echte Person	smalltalk.agent.real	Editorial.SmallTalk
du bist nicht echt	smalltalk.agent.real	Editorial.SmallTalk
Wo wohnst du	smalltalk.agent.residence	Editorial.SmallTalk
In welcher Stadt lebst du	smalltalk.agent.residence	Editorial.SmallTalk
Dein Wohnort	smalltalk.agent.residence	Editorial.SmallTalk
dein Haus	smalltalk.agent.residence	Editorial.SmallTalk
Ihr Haus	smalltalk.agent.residence	Editorial.SmallTalk
Deine Heimatstadt	smalltalk.agent.residence	Editorial.SmallTalk
Was ist deine Heimatstadt	smalltalk.agent.residence	Editorial.SmallTalk
Ist es deine Heimatstadt?	smalltalk.agent.residence	Editorial.SmallTalk
wo liegt deine Heimatstadt	smalltalk.agent.residence	Editorial.SmallTalk
Erzähl mir etwas über deine Stadt	smalltalk.agent.residence	Editorial.SmallTalk
Was ist deine Stadt	smalltalk.agent.residence	Editorial.SmallTalk
Was ist Ihr Wohnsitz?	smalltalk.agent.residence	Editorial.SmallTalk
Was ist deine Stadt?	smalltalk.agent.residence	Editorial.SmallTalk
Was ist deine Stadt?	smalltalk.agent.residence	Editorial.SmallTalk
Was ist dein Zuhause?	smalltalk.agent.residence	Editorial.SmallTalk
wo ist Ihr Zuhause	smalltalk.agent.residence	Editorial.SmallTalk
Wo ist Ihr Wohnsitz?	smalltalk.agent.residence	Editorial.SmallTalk
Wo ist dein Zuhause?	smalltalk.agent.residence	Editorial.SmallTalk
Wo ist deine Heimatstadt?	smalltalk.agent.residence	Editorial.SmallTalk
wo ist dein Haus	smalltalk.agent.residence	Editorial.SmallTalk
wo Sie leben	smalltalk.agent.residence	Editorial.SmallTalk
deine Stadt	smalltalk.agent.residence	Editorial.SmallTalk
deine Stadt	smalltalk.agent.residence	Editorial.SmallTalk
das ist richtig	smalltalk.agent.right	Editorial.SmallTalk
du hast Recht	smalltalk.agent.right	Editorial.SmallTalk
du hast auf jeden Fall Recht	smalltalk.agent.right	Editorial.SmallTalk
du liegst nicht falsch	smalltalk.agent.right	Editorial.SmallTalk
Du sagst die Wahrheit	smalltalk.agent.right	Editorial.SmallTalk
"was du sagst, ist wahr"	smalltalk.agent.right	Editorial.SmallTalk
WAHR	smalltalk.agent.right	Editorial.SmallTalk
es stimmt	smalltalk.agent.right	Editorial.SmallTalk
es ist richtig	smalltalk.agent.right	Editorial.SmallTalk
es ist die Wahrheit	smalltalk.agent.right	Editorial.SmallTalk
das ist wahr	smalltalk.agent.right	Editorial.SmallTalk
das ist richtig	smalltalk.agent.right	Editorial.SmallTalk
das ist richtig	smalltalk.agent.right	Editorial.SmallTalk
das ist wahr	smalltalk.agent.right	Editorial.SmallTalk
das ist sehr wahr	smalltalk.agent.right	Editorial.SmallTalk
Das ist wirklich wahr	smalltalk.agent.right	Editorial.SmallTalk
Du hast Recht	smalltalk.agent.right	Editorial.SmallTalk
du hast ja so recht	smalltalk.agent.right	Editorial.SmallTalk
Du hast absolut recht	smalltalk.agent.right	Editorial.SmallTalk
Da hast du recht	smalltalk.agent.right	Editorial.SmallTalk
"Ich weiß, dass das richtig ist"	smalltalk.agent.right	Editorial.SmallTalk
das ist richtig	smalltalk.confirmation.yes	Editorial.SmallTalk
Das ist gut	smalltalk.confirmation.yes	Editorial.SmallTalk
fortfahren	smalltalk.confirmation.yes	Editorial.SmallTalk
hört sich gut an	smalltalk.confirmation.yes	Editorial.SmallTalk
Okay	smalltalk.confirmation.yes	Editorial.SmallTalk
Ja	smalltalk.confirmation.yes	Editorial.SmallTalk
OK	smalltalk.confirmation.yes	Editorial.SmallTalk
okie dokie	smalltalk.confirmation.yes	Editorial.SmallTalk
Sicher	smalltalk.confirmation.yes	Editorial.SmallTalk
Tue es	smalltalk.confirmation.yes	Editorial.SmallTalk
Ja	smalltalk.confirmation.yes	Editorial.SmallTalk
Ja	smalltalk.confirmation.yes	Editorial.SmallTalk
Tu es	smalltalk.confirmation.yes	Editorial.SmallTalk
Natürlich	smalltalk.confirmation.yes	Editorial.SmallTalk
Ich schätze	smalltalk.confirmation.yes	Editorial.SmallTalk
richtig	smalltalk.confirmation.yes	Editorial.SmallTalk
ja sicher	smalltalk.confirmation.yes	Editorial.SmallTalk
Warum nicht	smalltalk.confirmation.yes	Editorial.SmallTalk
Bitte	smalltalk.confirmation.yes	Editorial.SmallTalk
sicher ist	smalltalk.confirmation.yes	Editorial.SmallTalk
Ich stimme zu	smalltalk.confirmation.yes	Editorial.SmallTalk
Es macht mir nichts aus	smalltalk.confirmation.yes	Editorial.SmallTalk
sicherlich	smalltalk.confirmation.yes	Editorial.SmallTalk
genau	smalltalk.confirmation.yes	Editorial.SmallTalk
"Ja, ich stimme zu"	smalltalk.confirmation.yes	Editorial.SmallTalk
Ich glaube schon	smalltalk.confirmation.yes	Editorial.SmallTalk
"Ja, so ist es"	smalltalk.confirmation.yes	Editorial.SmallTalk
Rechts	smalltalk.confirmation.yes	Editorial.SmallTalk
alles klar	smalltalk.confirmation.yes	Editorial.SmallTalk
Ja natürlich	smalltalk.confirmation.yes	Editorial.SmallTalk
"Ja, das tue ich"	smalltalk.confirmation.yes	Editorial.SmallTalk
das ist okay	smalltalk.confirmation.yes	Editorial.SmallTalk
Ich tue	smalltalk.confirmation.yes	Editorial.SmallTalk
Jawohl	smalltalk.confirmation.yes	Editorial.SmallTalk
Ja	smalltalk.confirmation.yes	Editorial.SmallTalk
Oh ja	smalltalk.confirmation.yes	Editorial.SmallTalk
ja sicher	smalltalk.confirmation.yes	Editorial.SmallTalk
offensichtlich	smalltalk.confirmation.yes	Editorial.SmallTalk
k	smalltalk.confirmation.yes	Editorial.SmallTalk
sicher warum nicht	smalltalk.confirmation.yes	Editorial.SmallTalk
"ja, genau"	smalltalk.confirmation.yes	Editorial.SmallTalk
ja natürlich	smalltalk.confirmation.yes	Editorial.SmallTalk
absolut	smalltalk.confirmation.yes	Editorial.SmallTalk
"Ja, tatsächlich"	smalltalk.confirmation.yes	Editorial.SmallTalk
OK sicher	smalltalk.confirmation.yes	Editorial.SmallTalk
OK ja	smalltalk.confirmation.yes	Editorial.SmallTalk
Ja richtig	smalltalk.confirmation.yes	Editorial.SmallTalk
OK danke	smalltalk.confirmation.yes	Editorial.SmallTalk
sichere Sache	smalltalk.confirmation.yes	Editorial.SmallTalk
Ihr	smalltalk.confirmation.yes	Editorial.SmallTalk
bestätigen	smalltalk.confirmation.yes	Editorial.SmallTalk
ja	smalltalk.confirmation.yes	Editorial.SmallTalk
sieht gut aus	smalltalk.confirmation.yes	Editorial.SmallTalk
ja Dankeschön	smalltalk.confirmation.yes	Editorial.SmallTalk
definitiv	smalltalk.confirmation.yes	Editorial.SmallTalk
ja richtig	smalltalk.confirmation.yes	Editorial.SmallTalk
"ja, würde ich gerne"	smalltalk.confirmation.yes	Editorial.SmallTalk
Okay	smalltalk.confirmation.yes	Editorial.SmallTalk
ja auf jeden Fall	smalltalk.confirmation.yes	Editorial.SmallTalk
Ja	smalltalk.confirmation.yes	Editorial.SmallTalk
"Ja, das ist richtig"	smalltalk.confirmation.yes	Editorial.SmallTalk
ja das ist richtig	smalltalk.confirmation.yes	Editorial.SmallTalk
OK du kannst	smalltalk.confirmation.yes	Editorial.SmallTalk
kläffen	smalltalk.confirmation.yes	Editorial.SmallTalk
"Ja, Sie dürfen"	smalltalk.confirmation.yes	Editorial.SmallTalk
bestätigt	smalltalk.confirmation.yes	Editorial.SmallTalk
"Natürlich, warum nicht"	smalltalk.confirmation.yes	Editorial.SmallTalk
ja das ist in Ordnung	smalltalk.confirmation.yes	Editorial.SmallTalk
positiv	smalltalk.confirmation.yes	Editorial.SmallTalk
"Ja, mach weiter"	smalltalk.confirmation.yes	Editorial.SmallTalk
"ja, ich bin sicher"	smalltalk.confirmation.yes	Editorial.SmallTalk
okay. Klingt gut	smalltalk.confirmation.yes	Editorial.SmallTalk
Ok das ist gut	smalltalk.confirmation.yes	Editorial.SmallTalk
ja genau	smalltalk.confirmation.yes	Editorial.SmallTalk
das ist ok	smalltalk.confirmation.yes	Editorial.SmallTalk
das ist richtig	smalltalk.confirmation.yes	Editorial.SmallTalk
OK fortfahren	smalltalk.confirmation.yes	Editorial.SmallTalk
ja das ist korrekt	smalltalk.confirmation.yes	Editorial.SmallTalk
"Egal, es ist okay"	smalltalk.confirmation.yes	Editorial.SmallTalk
Okay	smalltalk.confirmation.yes	Editorial.SmallTalk
ja sicher	smalltalk.confirmation.yes	Editorial.SmallTalk
in Ordnung	smalltalk.confirmation.yes	Editorial.SmallTalk
bist du sicher	smalltalk.agent.sure	Editorial.SmallTalk
Bist du jetzt sicher?	smalltalk.agent.sure	Editorial.SmallTalk
Bist du dir heute sicher?	smalltalk.agent.sure	Editorial.SmallTalk
Bist du jetzt sicher?	smalltalk.agent.sure	Editorial.SmallTalk
Bist du heute Abend sicher?	smalltalk.agent.sure	Editorial.SmallTalk
Warum redest du nicht mit mir?	smalltalk.agent.talk_to_me	Editorial.SmallTalk
Wollen sie sich mit mir unterhalten	smalltalk.agent.talk_to_me	Editorial.SmallTalk
wirst du mit mir reden?	smalltalk.agent.talk_to_me	Editorial.SmallTalk
sprechen Sie mit mir	smalltalk.agent.talk_to_me	Editorial.SmallTalk
wirst du mit mir sprechen	smalltalk.agent.talk_to_me	Editorial.SmallTalk
sprichst du mit mir	smalltalk.agent.talk_to_me	Editorial.SmallTalk
kannst du dich mit mir unterhalten	smalltalk.agent.talk_to_me	Editorial.SmallTalk
kannst du mit mir sprechen	smalltalk.agent.talk_to_me	Editorial.SmallTalk
kannst du mit mir reden	smalltalk.agent.talk_to_me	Editorial.SmallTalk
kannst du mit mir sprechen	smalltalk.agent.talk_to_me	Editorial.SmallTalk
sagen	smalltalk.agent.talk_to_me	Editorial.SmallTalk
sprechen	smalltalk.agent.talk_to_me	Editorial.SmallTalk
Rede mit mir	smalltalk.agent.talk_to_me	Editorial.SmallTalk
Chatte einfach mit mir	smalltalk.agent.talk_to_me	Editorial.SmallTalk
sprechen Sie mit mir	smalltalk.agent.talk_to_me	Editorial.SmallTalk
Rede mit mir	smalltalk.agent.talk_to_me	Editorial.SmallTalk
sprich mit mir	smalltalk.agent.talk_to_me	Editorial.SmallTalk
Warum redest du nicht mit mir?	smalltalk.agent.talk_to_me	Editorial.SmallTalk
du kannst mit mir sprechen	smalltalk.agent.talk_to_me	Editorial.SmallTalk
Bist du da	smalltalk.agent.there	Editorial.SmallTalk
du bist dort	smalltalk.agent.there	Editorial.SmallTalk
Bist du in meiner Nähe?	smalltalk.agent.there	Editorial.SmallTalk
Sind Sie hier	smalltalk.agent.there	Editorial.SmallTalk
bist du noch da	smalltalk.agent.there	Editorial.SmallTalk
Sie sind hier	smalltalk.agent.there	Editorial.SmallTalk
Du bist immer noch da	smalltalk.agent.there	Editorial.SmallTalk
bist du noch da	smalltalk.agent.there	Editorial.SmallTalk
ziemlich schlecht	smalltalk.appraisal.bad	Editorial.SmallTalk
nicht gut genug	smalltalk.appraisal.bad	Editorial.SmallTalk
das war lahm	smalltalk.appraisal.bad	Editorial.SmallTalk
das war schrecklich	smalltalk.appraisal.bad	Editorial.SmallTalk
es ist schlecht	smalltalk.appraisal.bad	Editorial.SmallTalk
das ist schlecht	smalltalk.appraisal.bad	Editorial.SmallTalk
das ist schlecht	smalltalk.appraisal.bad	Editorial.SmallTalk
nicht gut	smalltalk.appraisal.bad	Editorial.SmallTalk
"Ich fürchte, es ist schlimm"	smalltalk.appraisal.bad	Editorial.SmallTalk
"Nein, es ist schlecht"	smalltalk.appraisal.bad	Editorial.SmallTalk
Das war schrecklich	smalltalk.appraisal.bad	Editorial.SmallTalk
schlecht	smalltalk.appraisal.bad	Editorial.SmallTalk
so schlecht	smalltalk.appraisal.bad	Editorial.SmallTalk
das ist schade	smalltalk.appraisal.bad	Editorial.SmallTalk
schrecklich	smalltalk.appraisal.bad	Editorial.SmallTalk
schrecklich	smalltalk.appraisal.bad	Editorial.SmallTalk
schrecklich	smalltalk.appraisal.bad	Editorial.SmallTalk
miserabel	smalltalk.appraisal.bad	Editorial.SmallTalk
es ist schlecht	smalltalk.appraisal.bad	Editorial.SmallTalk
nicht gut	smalltalk.appraisal.bad	Editorial.SmallTalk
das war schlecht	smalltalk.appraisal.bad	Editorial.SmallTalk
das war schrecklich	smalltalk.appraisal.bad	Editorial.SmallTalk
das ist lahm	smalltalk.appraisal.bad	Editorial.SmallTalk
Das ist nicht gut	smalltalk.appraisal.bad	Editorial.SmallTalk
das ist furchtbar	smalltalk.appraisal.bad	Editorial.SmallTalk
das ist sehr schade	smalltalk.appraisal.bad	Editorial.SmallTalk
das ist nicht gut	smalltalk.appraisal.bad	Editorial.SmallTalk
schade	smalltalk.appraisal.bad	Editorial.SmallTalk
sehr schlecht	smalltalk.appraisal.bad	Editorial.SmallTalk
Böses Mädchen	smalltalk.appraisal.bad	Editorial.SmallTalk
es ist nicht gut	smalltalk.appraisal.bad	Editorial.SmallTalk
nicht so gut	smalltalk.appraisal.bad	Editorial.SmallTalk
es ist sehr schlimm	smalltalk.appraisal.bad	Editorial.SmallTalk
Das ist schade	smalltalk.appraisal.bad	Editorial.SmallTalk
das ist nicht gut genug	smalltalk.appraisal.bad	Editorial.SmallTalk
"Na ja, zu dumm"	smalltalk.appraisal.bad	Editorial.SmallTalk
"schlecht, sehr schlecht"	smalltalk.appraisal.bad	Editorial.SmallTalk
es ist so schlecht	smalltalk.appraisal.bad	Editorial.SmallTalk
wirklich schlecht	smalltalk.appraisal.bad	Editorial.SmallTalk
es ist sehr schlecht	smalltalk.appraisal.bad	Editorial.SmallTalk
schlechte Idee	smalltalk.appraisal.bad	Editorial.SmallTalk
das ist schlecht	smalltalk.appraisal.bad	Editorial.SmallTalk
das war nicht gut	smalltalk.appraisal.bad	Editorial.SmallTalk
es ist nicht so gut	smalltalk.appraisal.bad	Editorial.SmallTalk
kein guter	smalltalk.appraisal.bad	Editorial.SmallTalk
"Oh, das ist nicht gut"	smalltalk.appraisal.bad	Editorial.SmallTalk
nicht so gut	smalltalk.appraisal.bad	Editorial.SmallTalk
so lahm	smalltalk.appraisal.bad	Editorial.SmallTalk
Das ist wirklich schlimm	smalltalk.appraisal.bad	Editorial.SmallTalk
es ist schade	smalltalk.appraisal.bad	Editorial.SmallTalk
"schlecht, wirklich schlecht"	smalltalk.appraisal.bad	Editorial.SmallTalk
so cool	smalltalk.appraisal.good	Editorial.SmallTalk
Cool	smalltalk.appraisal.good	Editorial.SmallTalk
das ist gut	smalltalk.appraisal.good	Editorial.SmallTalk
freut mich das zu hören	smalltalk.appraisal.good	Editorial.SmallTalk
das ist sehr nett von dir	smalltalk.appraisal.good	Editorial.SmallTalk
ausgezeichnet	smalltalk.appraisal.good	Editorial.SmallTalk
es ist wunderbar	smalltalk.appraisal.good	Editorial.SmallTalk
das ist großartig	smalltalk.appraisal.good	Editorial.SmallTalk
perfekt	smalltalk.appraisal.good	Editorial.SmallTalk
exzellent	smalltalk.appraisal.good	Editorial.SmallTalk
das ist großartig	smalltalk.appraisal.good	Editorial.SmallTalk
das ist gut	smalltalk.appraisal.good	Editorial.SmallTalk
Es ist großartig	smalltalk.appraisal.good	Editorial.SmallTalk
Bußgeld	smalltalk.appraisal.good	Editorial.SmallTalk
Gut	smalltalk.appraisal.good	Editorial.SmallTalk
Hübsch	smalltalk.appraisal.good	Editorial.SmallTalk
das ist in Ordnung	smalltalk.appraisal.good	Editorial.SmallTalk
sehr gut	smalltalk.appraisal.good	Editorial.SmallTalk
toll	smalltalk.appraisal.good	Editorial.SmallTalk
fantastisch	smalltalk.appraisal.good	Editorial.SmallTalk
Großartig	smalltalk.appraisal.good	Editorial.SmallTalk
"gut, sehr gut"	smalltalk.appraisal.good	Editorial.SmallTalk
das ist sehr gut	smalltalk.appraisal.good	Editorial.SmallTalk
wirklich gut	smalltalk.appraisal.good	Editorial.SmallTalk
es ist in Ordnung	smalltalk.appraisal.good	Editorial.SmallTalk
es ist gut	smalltalk.appraisal.good	Editorial.SmallTalk
es ist perfekt	smalltalk.appraisal.good	Editorial.SmallTalk
viel besser	smalltalk.appraisal.good	Editorial.SmallTalk
nicht schlecht	smalltalk.appraisal.good	Editorial.SmallTalk
nicht so schlecht	smalltalk.appraisal.good	Editorial.SmallTalk
es ist sehr gut	smalltalk.appraisal.good	Editorial.SmallTalk
fabelhaft	smalltalk.appraisal.good	Editorial.SmallTalk
Freut mich	smalltalk.appraisal.good	Editorial.SmallTalk
angenehm	smalltalk.appraisal.good	Editorial.SmallTalk
ziemlich gut	smalltalk.appraisal.good	Editorial.SmallTalk
wirklich nett	smalltalk.appraisal.good	Editorial.SmallTalk
prächtig	smalltalk.appraisal.good	Editorial.SmallTalk
gerade	smalltalk.appraisal.good	Editorial.SmallTalk
super	smalltalk.appraisal.good	Editorial.SmallTalk
super fantastisch	smalltalk.appraisal.good	Editorial.SmallTalk
süß	smalltalk.appraisal.good	Editorial.SmallTalk
sehr gut	smalltalk.appraisal.good	Editorial.SmallTalk
sehr gut	smalltalk.appraisal.good	Editorial.SmallTalk
das ist fantastisch	smalltalk.appraisal.good	Editorial.SmallTalk
das ist nett	smalltalk.appraisal.good	Editorial.SmallTalk
das ist wundervoll	smalltalk.appraisal.good	Editorial.SmallTalk
das war Hervorragend	smalltalk.appraisal.good	Editorial.SmallTalk
das war wunderbar	smalltalk.appraisal.good	Editorial.SmallTalk
Das war süß	smalltalk.appraisal.good	Editorial.SmallTalk
das war ziemlich gut	smalltalk.appraisal.good	Editorial.SmallTalk
das war sehr gut	smalltalk.appraisal.good	Editorial.SmallTalk
das ist eine gute Idee	smalltalk.appraisal.good	Editorial.SmallTalk
das ist gut	smalltalk.appraisal.good	Editorial.SmallTalk
das ist erstaunlich	smalltalk.appraisal.good	Editorial.SmallTalk
"Das ist großartig, danke"	smalltalk.appraisal.good	Editorial.SmallTalk
das ist besser	smalltalk.appraisal.good	Editorial.SmallTalk
das ist süß	smalltalk.appraisal.good	Editorial.SmallTalk
das ist fantastisch	smalltalk.appraisal.good	Editorial.SmallTalk
das ist viel besser	smalltalk.appraisal.good	Editorial.SmallTalk
das ist nett von dir	smalltalk.appraisal.good	Editorial.SmallTalk
das ist nicht schlecht	smalltalk.appraisal.good	Editorial.SmallTalk
Das ist großartig	smalltalk.appraisal.good	Editorial.SmallTalk
Das ist sehr gut	smalltalk.appraisal.good	Editorial.SmallTalk
das ist wirklich gut	smalltalk.appraisal.good	Editorial.SmallTalk
das ist wirklich schön	smalltalk.appraisal.good	Editorial.SmallTalk
das ist süß von dir	smalltalk.appraisal.good	Editorial.SmallTalk
das ist sehr nett	smalltalk.appraisal.good	Editorial.SmallTalk
das ist wunderbar	smalltalk.appraisal.good	Editorial.SmallTalk
das ist fantastisch	smalltalk.appraisal.good	Editorial.SmallTalk
das ist gut	smalltalk.appraisal.good	Editorial.SmallTalk
das ist toll	smalltalk.appraisal.good	Editorial.SmallTalk
sehr schön	smalltalk.appraisal.good	Editorial.SmallTalk
dann sehr	smalltalk.appraisal.good	Editorial.SmallTalk
wunderbar	smalltalk.appraisal.good	Editorial.SmallTalk
"Ich bin froh, das zu hören"	smalltalk.appraisal.good	Editorial.SmallTalk
okay gut	smalltalk.appraisal.good	Editorial.SmallTalk
Schön für dich	smalltalk.appraisal.good	Editorial.SmallTalk
gut zu wissen	smalltalk.appraisal.good	Editorial.SmallTalk
froh das zu hören	smalltalk.appraisal.good	Editorial.SmallTalk
so gut	smalltalk.appraisal.good	Editorial.SmallTalk
so süß von dir	smalltalk.appraisal.good	Editorial.SmallTalk
es war gut	smalltalk.appraisal.good	Editorial.SmallTalk
nun ja	smalltalk.appraisal.good	Editorial.SmallTalk
gute Sache	smalltalk.appraisal.good	Editorial.SmallTalk
das war gut	smalltalk.appraisal.good	Editorial.SmallTalk
Es ist toll	smalltalk.appraisal.good	Editorial.SmallTalk
okay gut	smalltalk.appraisal.good	Editorial.SmallTalk
nein das ist in Ordnung	smalltalk.appraisal.good	Editorial.SmallTalk
das ist in Ordnung	smalltalk.appraisal.good	Editorial.SmallTalk
Keine Sorge	smalltalk.appraisal.no_problem	Editorial.SmallTalk
kein Problem	smalltalk.appraisal.no_problem	Editorial.SmallTalk
Kein Problem	smalltalk.appraisal.no_problem	Editorial.SmallTalk
es gibt keine Probleme	smalltalk.appraisal.no_problem	Editorial.SmallTalk
sicher kein Problem	smalltalk.appraisal.no_problem	Editorial.SmallTalk
Kein Problem damit	smalltalk.appraisal.no_problem	Editorial.SmallTalk
Mach dir keine Sorgen	smalltalk.appraisal.no_problem	Editorial.SmallTalk
"Keine Sorge, es gibt kein Problem"	smalltalk.appraisal.no_problem	Editorial.SmallTalk
"Du hast sehr geholfen, vielen Dank"	smalltalk.appraisal.thank_you	Editorial.SmallTalk
schätze deine Hilfe	smalltalk.appraisal.thank_you	Editorial.SmallTalk
Prost	smalltalk.appraisal.thank_you	Editorial.SmallTalk
Danke	smalltalk.appraisal.thank_you	Editorial.SmallTalk
Danke	smalltalk.appraisal.thank_you	Editorial.SmallTalk
vielen Dank	smalltalk.appraisal.thank_you	Editorial.SmallTalk
"super, danke"	smalltalk.appraisal.thank_you	Editorial.SmallTalk
grosses Dankeschön	smalltalk.appraisal.thank_you	Editorial.SmallTalk
Vielen Dank	smalltalk.appraisal.thank_you	Editorial.SmallTalk
Vielen Dank	smalltalk.appraisal.thank_you	Editorial.SmallTalk
Vielen Dank für Ihre Hilfe	smalltalk.appraisal.thank_you	Editorial.SmallTalk
Ich danke Ihnen für Ihre Hilfe	smalltalk.appraisal.thank_you	Editorial.SmallTalk
"Nett, danke"	smalltalk.appraisal.thank_you	Editorial.SmallTalk
Ich schätze es	smalltalk.appraisal.thank_you	Editorial.SmallTalk
ich danke dir	smalltalk.appraisal.thank_you	Editorial.SmallTalk
"Danke, das wird alles sein"	smalltalk.appraisal.thank_you	Editorial.SmallTalk
Danke Kumpel	smalltalk.appraisal.thank_you	Editorial.SmallTalk
Danke Liebling	smalltalk.appraisal.thank_you	Editorial.SmallTalk
Danke mein Freund	smalltalk.appraisal.thank_you	Editorial.SmallTalk
"Gut, danke"	smalltalk.appraisal.thank_you	Editorial.SmallTalk
sehr gut danke	smalltalk.appraisal.thank_you	Editorial.SmallTalk
gut danke	smalltalk.appraisal.thank_you	Editorial.SmallTalk
Danke noch einmal	smalltalk.appraisal.thank_you	Editorial.SmallTalk
Danke nochmal	smalltalk.appraisal.thank_you	Editorial.SmallTalk
Danke euch allen	smalltalk.appraisal.thank_you	Editorial.SmallTalk
"Alles klar, danke"	smalltalk.appraisal.thank_you	Editorial.SmallTalk
"gut, danke"	smalltalk.appraisal.thank_you	Editorial.SmallTalk
"Nein danke, das ist alles"	smalltalk.appraisal.thank_you	Editorial.SmallTalk
"perfekt, danke"	smalltalk.appraisal.thank_you	Editorial.SmallTalk
so nett von dir	smalltalk.appraisal.thank_you	Editorial.SmallTalk
"Nun ja, danke"	smalltalk.appraisal.thank_you	Editorial.SmallTalk
Danke	smalltalk.appraisal.thank_you	Editorial.SmallTalk
Danke	smalltalk.appraisal.thank_you	Editorial.SmallTalk
das ist mir ein Vergnügen	smalltalk.appraisal.welcome	Editorial.SmallTalk
freut mich	smalltalk.appraisal.welcome	Editorial.SmallTalk
jederzeit	smalltalk.appraisal.welcome	Editorial.SmallTalk
Willkommen	smalltalk.appraisal.welcome	Editorial.SmallTalk
Gern geschehen	smalltalk.appraisal.welcome	Editorial.SmallTalk
sicher willkommen	smalltalk.appraisal.welcome	Editorial.SmallTalk
willkommen hier	smalltalk.appraisal.welcome	Editorial.SmallTalk
bitteschön	smalltalk.appraisal.welcome	Editorial.SmallTalk
alles was du willst	smalltalk.appraisal.welcome	Editorial.SmallTalk
gute Arbeit	smalltalk.appraisal.well_done	Editorial.SmallTalk
gut gemacht	smalltalk.appraisal.well_done	Editorial.SmallTalk
Weg zu gehen	smalltalk.appraisal.well_done	Editorial.SmallTalk
gut gemacht	smalltalk.appraisal.well_done	Editorial.SmallTalk
gute Arbeit	smalltalk.appraisal.well_done	Editorial.SmallTalk
Gute Arbeit	smalltalk.appraisal.well_done	Editorial.SmallTalk
tolle Arbeit	smalltalk.appraisal.well_done	Editorial.SmallTalk
Bravo	smalltalk.appraisal.well_done	Editorial.SmallTalk
gute Arbeit	smalltalk.appraisal.well_done	Editorial.SmallTalk
stornieren	smalltalk.confirmation.cancel	Editorial.SmallTalk
abbrechen	smalltalk.confirmation.cancel	Editorial.SmallTalk
annullieren	smalltalk.confirmation.cancel	Editorial.SmallTalk
Sag es ab	smalltalk.confirmation.cancel	Editorial.SmallTalk
Anfrage abbrechen	smalltalk.confirmation.cancel	Editorial.SmallTalk
abgesagt	smalltalk.confirmation.cancel	Editorial.SmallTalk
zurückweisen	smalltalk.confirmation.cancel	Editorial.SmallTalk
entlassen	smalltalk.confirmation.cancel	Editorial.SmallTalk
außer Acht lassen	smalltalk.confirmation.cancel	Editorial.SmallTalk
ignoriere das	smalltalk.confirmation.cancel	Editorial.SmallTalk
überspringen	smalltalk.confirmation.cancel	Editorial.SmallTalk
überspring es	smalltalk.confirmation.cancel	Editorial.SmallTalk
alles absagen	smalltalk.confirmation.cancel	Editorial.SmallTalk
alle Absagen	smalltalk.confirmation.cancel	Editorial.SmallTalk
Vergiss es	smalltalk.confirmation.cancel	Editorial.SmallTalk
vergessen	smalltalk.confirmation.cancel	Editorial.SmallTalk
Tu das nicht	smalltalk.confirmation.cancel	Editorial.SmallTalk
stoppen	smalltalk.confirmation.cancel	Editorial.SmallTalk
Vergiss es einfach	smalltalk.confirmation.cancel	Editorial.SmallTalk
vergess das	smalltalk.confirmation.cancel	Editorial.SmallTalk
verwerfen	smalltalk.confirmation.cancel	Editorial.SmallTalk
Vergiss das	smalltalk.confirmation.cancel	Editorial.SmallTalk
Vergiss es einfach	smalltalk.confirmation.cancel	Editorial.SmallTalk
Vergiss es	smalltalk.confirmation.cancel	Editorial.SmallTalk
Ich sagte abbrechen	smalltalk.confirmation.cancel	Editorial.SmallTalk
einfach abbrechen	smalltalk.confirmation.cancel	Editorial.SmallTalk
nichts stornieren	smalltalk.confirmation.cancel	Editorial.SmallTalk
Hör einfach auf	smalltalk.confirmation.cancel	Editorial.SmallTalk
Nein stornieren stornieren	smalltalk.confirmation.cancel	Editorial.SmallTalk
"Nein, einfach abbrechen"	smalltalk.confirmation.cancel	Editorial.SmallTalk
meine Anfrage stornieren	smalltalk.confirmation.cancel	Editorial.SmallTalk
Kannst du das abbrechen?	smalltalk.confirmation.cancel	Editorial.SmallTalk
das alles abbrechen	smalltalk.confirmation.cancel	Editorial.SmallTalk
Stornieren Sie diese Anfrage	smalltalk.confirmation.cancel	Editorial.SmallTalk
"Nein, stornieren Sie dies"	smalltalk.confirmation.cancel	Editorial.SmallTalk
"Nein, alles abbrechen"	smalltalk.confirmation.cancel	Editorial.SmallTalk
kein Halt	smalltalk.confirmation.cancel	Editorial.SmallTalk
einfach vergessen	smalltalk.confirmation.cancel	Editorial.SmallTalk
ich möchte stornieren	smalltalk.confirmation.cancel	Editorial.SmallTalk
Vergessen Sie es nicht	smalltalk.confirmation.cancel	Editorial.SmallTalk
"Nein, storniere es einfach"	smalltalk.confirmation.cancel	Editorial.SmallTalk
"nichts, vergiss es einfach"	smalltalk.confirmation.cancel	Editorial.SmallTalk
"Ich sagte, storniere es"	smalltalk.confirmation.cancel	Editorial.SmallTalk
das Ganze abbrechen	smalltalk.confirmation.cancel	Editorial.SmallTalk
Kannst du es stornieren?	smalltalk.confirmation.cancel	Editorial.SmallTalk
also abbrechen	smalltalk.confirmation.cancel	Editorial.SmallTalk
"Ich sagte, vergiss es"	smalltalk.confirmation.cancel	Editorial.SmallTalk
Storniere das alles	smalltalk.confirmation.cancel	Editorial.SmallTalk
"Vergiss es, egal"	smalltalk.confirmation.cancel	Editorial.SmallTalk
Hör auf	smalltalk.confirmation.cancel	Editorial.SmallTalk
Ich möchte es stornieren	smalltalk.confirmation.cancel	Editorial.SmallTalk
Ich möchte stornieren	smalltalk.confirmation.cancel	Editorial.SmallTalk
Jetzt abbrechen	smalltalk.confirmation.cancel	Editorial.SmallTalk
Jetzt kündigen	smalltalk.confirmation.cancel	Editorial.SmallTalk
"Entschuldigung, absagen"	smalltalk.confirmation.cancel	Editorial.SmallTalk
storniere das	smalltalk.confirmation.cancel	Editorial.SmallTalk
überspringen überspringen überspringen	smalltalk.confirmation.cancel	Editorial.SmallTalk
"abbrechen, abbrechen, abbrechen"	smalltalk.confirmation.cancel	Editorial.SmallTalk
"storniere das, storniere das"	smalltalk.confirmation.cancel	Editorial.SmallTalk
nichts tun	smalltalk.confirmation.cancel	Editorial.SmallTalk
"Ich sagte „Abbrechen, Abbrechen“."	smalltalk.confirmation.cancel	Editorial.SmallTalk
Aber kannst du es stornieren?	smalltalk.confirmation.cancel	Editorial.SmallTalk
Wie wäre es mit nein	smalltalk.confirmation.no	Editorial.SmallTalk
Habe keinen Sinn	smalltalk.confirmation.no	Editorial.SmallTalk
NEIN	smalltalk.confirmation.no	Editorial.SmallTalk
nicht	smalltalk.confirmation.no	Editorial.SmallTalk
Das will ich nicht	smalltalk.confirmation.no	Editorial.SmallTalk
ich bin nicht einverstanden	smalltalk.confirmation.no	Editorial.SmallTalk
verschiedener Meinung sein	smalltalk.confirmation.no	Editorial.SmallTalk
Ich will nicht	smalltalk.confirmation.no	Editorial.SmallTalk
nicht interessiert	smalltalk.confirmation.no	Editorial.SmallTalk
Das glaube ich nicht	smalltalk.confirmation.no	Editorial.SmallTalk
auf keinen Fall	smalltalk.confirmation.no	Editorial.SmallTalk
"Nein, ist es nicht"	smalltalk.confirmation.no	Editorial.SmallTalk
"Nein, das tue ich nicht"	smalltalk.confirmation.no	Editorial.SmallTalk
Ich bin nicht	smalltalk.confirmation.no	Editorial.SmallTalk
n / A	smalltalk.confirmation.no	Editorial.SmallTalk
"Nein, das ist in Ordnung, danke"	smalltalk.confirmation.no	Editorial.SmallTalk
niemals	smalltalk.confirmation.no	Editorial.SmallTalk
Ich sagte nein	smalltalk.confirmation.no	Editorial.SmallTalk
natürlich nicht	smalltalk.confirmation.no	Editorial.SmallTalk
Nein	smalltalk.confirmation.no	Editorial.SmallTalk
Nein Danke	smalltalk.confirmation.no	Editorial.SmallTalk
Nein niemals	smalltalk.confirmation.no	Editorial.SmallTalk
keine Notwendigkeit	smalltalk.confirmation.no	Editorial.SmallTalk
Nein danke	smalltalk.confirmation.no	Editorial.SmallTalk
Nein Entschuldigung	smalltalk.confirmation.no	Editorial.SmallTalk
nicht	smalltalk.confirmation.no	Editorial.SmallTalk
nicht heute	smalltalk.confirmation.no	Editorial.SmallTalk
"Nein, ist es nicht"	smalltalk.confirmation.no	Editorial.SmallTalk
absolut nicht	smalltalk.confirmation.no	Editorial.SmallTalk
nicht das	smalltalk.confirmation.no	Editorial.SmallTalk
Nein	smalltalk.confirmation.no	Editorial.SmallTalk
Nein	smalltalk.confirmation.no	Editorial.SmallTalk
Ich will nicht	smalltalk.confirmation.no	Editorial.SmallTalk
"Nein, würde ich nicht"	smalltalk.confirmation.no	Editorial.SmallTalk
Lass uns nicht	smalltalk.confirmation.no	Editorial.SmallTalk
nicht benötigt	smalltalk.confirmation.no	Editorial.SmallTalk
dieses Mal nicht	smalltalk.confirmation.no	Editorial.SmallTalk
"Nein, tu das nicht"	smalltalk.confirmation.no	Editorial.SmallTalk
"Danke, aber nein danke"	smalltalk.confirmation.no	Editorial.SmallTalk
Nein das ist falsch	smalltalk.confirmation.no	Editorial.SmallTalk
nicht das	smalltalk.confirmation.no	Editorial.SmallTalk
definitiv nicht	smalltalk.confirmation.no	Editorial.SmallTalk
nicht zu diesem Zeitpunkt	smalltalk.confirmation.no	Editorial.SmallTalk
nicht genau	smalltalk.confirmation.no	Editorial.SmallTalk
"Nein, nicht"	smalltalk.confirmation.no	Editorial.SmallTalk
"nicht wirklich, nein"	smalltalk.confirmation.no	Editorial.SmallTalk
"Nein danke, im Moment nicht"	smalltalk.confirmation.no	Editorial.SmallTalk
nicht wirklich	smalltalk.confirmation.no	Editorial.SmallTalk
"Nein, lass es"	smalltalk.confirmation.no	Editorial.SmallTalk
entschuldige Nein	smalltalk.confirmation.no	Editorial.SmallTalk
nein falsch	smalltalk.confirmation.no	Editorial.SmallTalk
Nein Entschuldigung	smalltalk.confirmation.no	Editorial.SmallTalk
Ich sage nein	smalltalk.confirmation.no	Editorial.SmallTalk
nicht wirklich	smalltalk.confirmation.no	Editorial.SmallTalk
"Im Moment nicht, danke"	smalltalk.confirmation.no	Editorial.SmallTalk
Ich denke nicht	smalltalk.confirmation.no	Editorial.SmallTalk
definitiv nein	smalltalk.confirmation.no	Editorial.SmallTalk
nicht wirklich	smalltalk.confirmation.no	Editorial.SmallTalk
scheinbar nicht	smalltalk.confirmation.no	Editorial.SmallTalk
"Nein, tu nicht"	smalltalk.confirmation.no	Editorial.SmallTalk
Nein einfach nein	smalltalk.confirmation.no	Editorial.SmallTalk
"nein, aber Danke"	smalltalk.confirmation.no	Editorial.SmallTalk
nicht nötig Danke	smalltalk.confirmation.no	Editorial.SmallTalk
nein danke aber	smalltalk.confirmation.no	Editorial.SmallTalk
"Nein, vielen Dank"	smalltalk.confirmation.no	Editorial.SmallTalk
"Nein danke, im Moment nicht"	smalltalk.confirmation.no	Editorial.SmallTalk
nicht vergessen	smalltalk.confirmation.no	Editorial.SmallTalk
Warte kurz	smalltalk.dialog.hold_on	Editorial.SmallTalk
könnten Sie warten	smalltalk.dialog.hold_on	Editorial.SmallTalk
warte bitte	smalltalk.dialog.hold_on	Editorial.SmallTalk
festhalten	smalltalk.dialog.hold_on	Editorial.SmallTalk
Warten	smalltalk.dialog.hold_on	Editorial.SmallTalk
"Oh, Moment mal"	smalltalk.dialog.hold_on	Editorial.SmallTalk
Warte mal	smalltalk.dialog.hold_on	Editorial.SmallTalk
beeil dich nicht	smalltalk.dialog.hold_on	Editorial.SmallTalk
willst du eine Umarmung	smalltalk.dialog.hug	Editorial.SmallTalk
umarme Dich	smalltalk.dialog.hug	Editorial.SmallTalk
willst du eine Umarmung	smalltalk.dialog.hug	Editorial.SmallTalk
darf ich dich umarmen	smalltalk.dialog.hug	Editorial.SmallTalk
Könntest du mich umarmen?	smalltalk.dialog.hug	Editorial.SmallTalk
Ich will eine Umarmung	smalltalk.dialog.hug	Editorial.SmallTalk
Umarmung	smalltalk.dialog.hug	Editorial.SmallTalk
umarme mich	smalltalk.dialog.hug	Editorial.SmallTalk
umarmt	smalltalk.dialog.hug	Editorial.SmallTalk
Du hast dich umarmt	smalltalk.dialog.hug	Editorial.SmallTalk
umarmen	smalltalk.dialog.hug	Editorial.SmallTalk
mich umarmen	smalltalk.dialog.hug	Editorial.SmallTalk
umarmte mich	smalltalk.dialog.hug	Editorial.SmallTalk
Willst du eine Umarmung	smalltalk.dialog.hug	Editorial.SmallTalk
eine Umarmung	smalltalk.dialog.hug	Editorial.SmallTalk
Es ist mir egal	smalltalk.dialog.i_do_not_care	Editorial.SmallTalk
Das sollte mich nicht interessieren	smalltalk.dialog.i_do_not_care	Editorial.SmallTalk
was auch immer	smalltalk.dialog.i_do_not_care	Editorial.SmallTalk
Das ist mir egal	smalltalk.dialog.i_do_not_care	Editorial.SmallTalk
Es ist mir überhaupt egal	smalltalk.dialog.i_do_not_care	Editorial.SmallTalk
nicht fürsorglich	smalltalk.dialog.i_do_not_care	Editorial.SmallTalk
ist mir überhaupt egal	smalltalk.dialog.i_do_not_care	Editorial.SmallTalk
ist mir überhaupt egal	smalltalk.dialog.i_do_not_care	Editorial.SmallTalk
kümmert mich überhaupt nicht	smalltalk.dialog.i_do_not_care	Editorial.SmallTalk
Verzeihung	smalltalk.dialog.sorry	Editorial.SmallTalk
sich entschuldigen	smalltalk.dialog.sorry	Editorial.SmallTalk
Ich entschuldige mich	smalltalk.dialog.sorry	Editorial.SmallTalk
Entschuldigung	smalltalk.dialog.sorry	Editorial.SmallTalk
Es tut mir Leid	smalltalk.dialog.sorry	Editorial.SmallTalk
es tut mir so leid	smalltalk.dialog.sorry	Editorial.SmallTalk
Entschuldigen Sie	smalltalk.dialog.sorry	Editorial.SmallTalk
Entschuldigung	smalltalk.dialog.sorry	Editorial.SmallTalk
Entschuldigung bei mir	smalltalk.dialog.sorry	Editorial.SmallTalk
Entschuldigung	smalltalk.dialog.sorry	Editorial.SmallTalk
Entschuldigung	smalltalk.dialog.sorry	Editorial.SmallTalk
wie bitte	smalltalk.dialog.sorry	Editorial.SmallTalk
Begnadigung	smalltalk.dialog.sorry	Editorial.SmallTalk
Ich sagte Entschuldigung	smalltalk.dialog.sorry	Editorial.SmallTalk
es tut mir echt leid	smalltalk.dialog.sorry	Editorial.SmallTalk
verzeihen Sie mir	smalltalk.dialog.sorry	Editorial.SmallTalk
Das tut mir leid	smalltalk.dialog.sorry	Editorial.SmallTalk
Tut mir leid	smalltalk.dialog.sorry	Editorial.SmallTalk
wirklich leid	smalltalk.dialog.sorry	Editorial.SmallTalk
Entschuldige vielmals	smalltalk.dialog.sorry	Editorial.SmallTalk
"Ok, tut mir Leid"	smalltalk.dialog.sorry	Editorial.SmallTalk
Ich möchte mich entschuldigen	smalltalk.dialog.sorry	Editorial.SmallTalk
"Okay, es tut mir leid"	smalltalk.dialog.sorry	Editorial.SmallTalk
"Okay, es tut mir Leid"	smalltalk.dialog.sorry	Editorial.SmallTalk
was genau meinst du	smalltalk.dialog.what_do_you_mean	Editorial.SmallTalk
Wie meinst du das	smalltalk.dialog.what_do_you_mean	Editorial.SmallTalk
meinst Du das	smalltalk.dialog.what_do_you_mean	Editorial.SmallTalk
was meinst du genau	smalltalk.dialog.what_do_you_mean	Editorial.SmallTalk
aber was meinst du	smalltalk.dialog.what_do_you_mean	Editorial.SmallTalk
das war falsch	smalltalk.dialog.wrong	Editorial.SmallTalk
Das habe ich nicht gefragt	smalltalk.dialog.wrong	Editorial.SmallTalk
das ist falsch	smalltalk.dialog.wrong	Editorial.SmallTalk
falsch	smalltalk.dialog.wrong	Editorial.SmallTalk
es ist nicht richtig	smalltalk.dialog.wrong	Editorial.SmallTalk
das ist nicht richtig	smalltalk.dialog.wrong	Editorial.SmallTalk
es ist falsch	smalltalk.dialog.wrong	Editorial.SmallTalk
das ist falsch	smalltalk.dialog.wrong	Editorial.SmallTalk
falsch	smalltalk.dialog.wrong	Editorial.SmallTalk
nicht richtig	smalltalk.dialog.wrong	Editorial.SmallTalk
Sie liegen falsch	smalltalk.dialog.wrong	Editorial.SmallTalk
nicht in Ordnung	smalltalk.dialog.wrong	Editorial.SmallTalk
huh	smalltalk.emotions.ha_ha	Editorial.SmallTalk
Lol	smalltalk.emotions.ha_ha	Editorial.SmallTalk
xd	smalltalk.emotions.ha_ha	Editorial.SmallTalk
Haha	smalltalk.emotions.ha_ha	Editorial.SmallTalk
Ahaha	smalltalk.emotions.ha_ha	Editorial.SmallTalk
"Aha, lol"	smalltalk.emotions.ha_ha	Editorial.SmallTalk
laut lachen	smalltalk.emotions.ha_ha	Editorial.SmallTalk
LMAO	smalltalk.emotions.ha_ha	Editorial.SmallTalk
Das ist lustig	smalltalk.emotions.ha_ha	Editorial.SmallTalk
Ah	smalltalk.emotions.ha_ha	Editorial.SmallTalk
ah ah ah	smalltalk.emotions.ha_ha	Editorial.SmallTalk
ah ah	smalltalk.emotions.ha_ha	Editorial.SmallTalk
Ahaha	smalltalk.emotions.ha_ha	Editorial.SmallTalk
Ahahaha	smalltalk.emotions.ha_ha	Editorial.SmallTalk
Ha	smalltalk.emotions.ha_ha	Editorial.SmallTalk
hahaha	smalltalk.emotions.ha_ha	Editorial.SmallTalk
ha ha ha ha	smalltalk.emotions.ha_ha	Editorial.SmallTalk
hah	smalltalk.emotions.ha_ha	Editorial.SmallTalk
Haha	smalltalk.emotions.ha_ha	Editorial.SmallTalk
"Haha, lustig"	smalltalk.emotions.ha_ha	Editorial.SmallTalk
haha haha haha	smalltalk.emotions.ha_ha	Editorial.SmallTalk
haha das ist lustig	smalltalk.emotions.ha_ha	Editorial.SmallTalk
haha sehr lustig	smalltalk.emotions.ha_ha	Editorial.SmallTalk
hahaha	smalltalk.emotions.ha_ha	Editorial.SmallTalk
hahaha lustig	smalltalk.emotions.ha_ha	Editorial.SmallTalk
hahaha sehr lustig	smalltalk.emotions.ha_ha	Editorial.SmallTalk
Er	smalltalk.emotions.ha_ha	Editorial.SmallTalk
hehe	smalltalk.emotions.ha_ha	Editorial.SmallTalk
hehehe	smalltalk.emotions.ha_ha	Editorial.SmallTalk
lmao	smalltalk.emotions.ha_ha	Editorial.SmallTalk
Wow	smalltalk.emotions.wow	Editorial.SmallTalk
Wow wow	smalltalk.emotions.wow	Editorial.SmallTalk
Wow wow wow	smalltalk.emotions.wow	Editorial.SmallTalk
wooow	smalltalk.emotions.wow	Editorial.SmallTalk
Woah	smalltalk.emotions.wow	Editorial.SmallTalk
"Okay, bis später"	smalltalk.greetings.bye	Editorial.SmallTalk
hoffe dich später zu sehen	smalltalk.greetings.bye	Editorial.SmallTalk
Bis bald	smalltalk.greetings.bye	Editorial.SmallTalk
bis zum nächsten Mal	smalltalk.greetings.bye	Editorial.SmallTalk
ich muss gehen	smalltalk.greetings.bye	Editorial.SmallTalk
Tschüss	smalltalk.greetings.bye	Editorial.SmallTalk
Verabschiedung	smalltalk.greetings.bye	Editorial.SmallTalk
Wir sehen uns	smalltalk.greetings.bye	Editorial.SmallTalk
bis bald	smalltalk.greetings.bye	Editorial.SmallTalk
Tschüss	smalltalk.greetings.bye	Editorial.SmallTalk
Verabschiedung	smalltalk.greetings.bye	Editorial.SmallTalk
Tschüss. Man sieht sich	smalltalk.greetings.bye	Editorial.SmallTalk
"Tschüss, bis bald"	smalltalk.greetings.bye	Editorial.SmallTalk
"Tschüss, pass auf dich auf"	smalltalk.greetings.bye	Editorial.SmallTalk
Ich sagte Tschüss	smalltalk.greetings.bye	Editorial.SmallTalk
macht nichts tschuess	smalltalk.greetings.bye	Editorial.SmallTalk
jetzt tschüss	smalltalk.greetings.bye	Editorial.SmallTalk
das ist alles auf Wiedersehen	smalltalk.greetings.bye	Editorial.SmallTalk
das war's auf Wiedersehen	smalltalk.greetings.bye	Editorial.SmallTalk
lass mich in ruhe	smalltalk.greetings.bye	Editorial.SmallTalk
Geh ins Bett	smalltalk.greetings.bye	Editorial.SmallTalk
Auf Wiedersehen	smalltalk.greetings.bye	Editorial.SmallTalk
Wir sprechen später	smalltalk.greetings.bye	Editorial.SmallTalk
du kannst jetzt gehen	smalltalk.greetings.bye	Editorial.SmallTalk
Hau ab	smalltalk.greetings.bye	Editorial.SmallTalk
"Tschüss, bis später"	smalltalk.greetings.bye	Editorial.SmallTalk
OK tschüss	smalltalk.greetings.bye	Editorial.SmallTalk
Tschüss	smalltalk.greetings.bye	Editorial.SmallTalk
"Danke, tschüss"	smalltalk.greetings.bye	Editorial.SmallTalk
"Okay, tschüss"	smalltalk.greetings.bye	Editorial.SmallTalk
"Okay, danke, tschüss"	smalltalk.greetings.bye	Editorial.SmallTalk
bis morgen	smalltalk.greetings.bye	Editorial.SmallTalk
"Ok, tschüss"	smalltalk.greetings.bye	Editorial.SmallTalk
Guten Abend	smalltalk.greetings.goodevening	Editorial.SmallTalk
Guten Abend	smalltalk.greetings.goodevening	Editorial.SmallTalk
Hallo guten Abend	smalltalk.greetings.goodevening	Editorial.SmallTalk
"Hallo, guten Abend"	smalltalk.greetings.goodevening	Editorial.SmallTalk
Abend	smalltalk.greetings.goodevening	Editorial.SmallTalk
Guten Abend dort	smalltalk.greetings.goodevening	Editorial.SmallTalk
Guten Morgen	smalltalk.greetings.goodmorning	Editorial.SmallTalk
guten Morgen	smalltalk.greetings.goodmorning	Editorial.SmallTalk
hallo guten Morgen	smalltalk.greetings.goodmorning	Editorial.SmallTalk
Ich wünsche dir einen schönen Morgen	smalltalk.greetings.goodmorning	Editorial.SmallTalk
Ich wünsche dir einen tollen Morgen	smalltalk.greetings.goodmorning	Editorial.SmallTalk
Morgen	smalltalk.greetings.goodmorning	Editorial.SmallTalk
guten Morgen an alle	smalltalk.greetings.goodmorning	Editorial.SmallTalk
Top des Morgens für dich	smalltalk.greetings.goodmorning	Editorial.SmallTalk
einen guten Morgen	smalltalk.greetings.goodmorning	Editorial.SmallTalk
"Hallo, guten Morgen"	smalltalk.greetings.goodmorning	Editorial.SmallTalk
und einen guten Morgen dir	smalltalk.greetings.goodmorning	Editorial.SmallTalk
auch einen guten Morgen	smalltalk.greetings.goodmorning	Editorial.SmallTalk
süsse Träume	smalltalk.greetings.goodnight	Editorial.SmallTalk
Gute Nacht	smalltalk.greetings.goodnight	Editorial.SmallTalk
gute Nacht	smalltalk.greetings.goodnight	Editorial.SmallTalk
Gute Nacht	smalltalk.greetings.goodnight	Editorial.SmallTalk
danke gute Nacht	smalltalk.greetings.goodnight	Editorial.SmallTalk
  Tschüss gute Nacht	smalltalk.greetings.goodnight	Editorial.SmallTalk
"gute Nacht, tschüss"	smalltalk.greetings.goodnight	Editorial.SmallTalk
Tschüss gute Nacht	smalltalk.greetings.goodnight	Editorial.SmallTalk
gute gute Nacht	smalltalk.greetings.goodnight	Editorial.SmallTalk
Gute Nacht für jetzt	smalltalk.greetings.goodnight	Editorial.SmallTalk
Gute Nacht	smalltalk.greetings.goodnight	Editorial.SmallTalk
Nacht	smalltalk.greetings.goodnight	Editorial.SmallTalk
"danke, gute Nacht"	smalltalk.greetings.goodnight	Editorial.SmallTalk
gute Nacht bis morgen	smalltalk.greetings.goodnight	Editorial.SmallTalk
in Ordnung gute Nacht	smalltalk.greetings.goodnight	Editorial.SmallTalk
gut heute Abend	smalltalk.greetings.goodnight	Editorial.SmallTalk
"Okay, ich wünsche dir eine gute Nacht"	smalltalk.greetings.goodnight	Editorial.SmallTalk
gute Nacht	smalltalk.greetings.goodnight	Editorial.SmallTalk
lange nicht gesehen	smalltalk.greetings.hello	Editorial.SmallTalk
Hallo	smalltalk.greetings.hello	Editorial.SmallTalk
Hi	smalltalk.greetings.hello	Editorial.SmallTalk
Hallo	smalltalk.greetings.hello	Editorial.SmallTalk
Hallo	smalltalk.greetings.hello	Editorial.SmallTalk
Hey	smalltalk.greetings.hello	Editorial.SmallTalk
Grüße	smalltalk.greetings.hello	Editorial.SmallTalk
Ich grüße Sie	smalltalk.greetings.hello	Editorial.SmallTalk
Hallo	smalltalk.greetings.hello	Editorial.SmallTalk
Hallo	smalltalk.greetings.hello	Editorial.SmallTalk
"Schöner Tag, nicht wahr?"	smalltalk.greetings.hello	Editorial.SmallTalk
Hallo wieder	smalltalk.greetings.hello	Editorial.SmallTalk
Ich sage nur Hallo	smalltalk.greetings.hello	Editorial.SmallTalk
ein guter Tag	smalltalk.greetings.hello	Editorial.SmallTalk
Nachmittag	smalltalk.greetings.hello	Editorial.SmallTalk
Hallo Hi	smalltalk.greetings.hello	Editorial.SmallTalk
heya	smalltalk.greetings.hello	Editorial.SmallTalk
Wie ist dein Morgen bisher?	smalltalk.greetings.how_are_you	Editorial.SmallTalk
Wie geht es dir?	smalltalk.greetings.how_are_you	Editorial.SmallTalk
Wie läuft dein Tag	smalltalk.greetings.how_are_you	Editorial.SmallTalk
Wie geht es dir	smalltalk.greetings.how_are_you	Editorial.SmallTalk
ist alles in Ordnung	smalltalk.greetings.how_are_you	Editorial.SmallTalk
Wie geht es dir	smalltalk.greetings.how_are_you	Editorial.SmallTalk
Wie läuft es?	smalltalk.greetings.how_are_you	Editorial.SmallTalk
geht es dir gut	smalltalk.greetings.how_are_you	Editorial.SmallTalk
geht es dir gut?	smalltalk.greetings.how_are_you	Editorial.SmallTalk
Wie fühlen Sie sich	smalltalk.greetings.how_are_you	Editorial.SmallTalk
wie geht es dir	smalltalk.greetings.how_are_you	Editorial.SmallTalk
Ist alles in Ordnung	smalltalk.greetings.how_are_you	Editorial.SmallTalk
wie geht es dir heute	smalltalk.greetings.how_are_you	Editorial.SmallTalk
Wie geht es dir?	smalltalk.greetings.how_are_you	Editorial.SmallTalk
wie fühlen Sie sich	smalltalk.greetings.how_are_you	Editorial.SmallTalk
Wie geht es dir?	smalltalk.greetings.how_are_you	Editorial.SmallTalk
Wie ist das	smalltalk.greetings.how_are_you	Editorial.SmallTalk
Wie geht es Ihnen	smalltalk.greetings.how_are_you	Editorial.SmallTalk
Wie geht es Heute	smalltalk.greetings.how_are_you	Editorial.SmallTalk
Wie läuft dein Tag?	smalltalk.greetings.how_are_you	Editorial.SmallTalk
Wie ist dein Abend	smalltalk.greetings.how_are_you	Editorial.SmallTalk
Wie war dein Tag	smalltalk.greetings.how_are_you	Editorial.SmallTalk
hast du einen guten Tag	smalltalk.greetings.how_are_you	Editorial.SmallTalk
"Ich hoffe, dein Tag verläuft gut"	smalltalk.greetings.how_are_you	Editorial.SmallTalk
"Ich hoffe, Sie haben einen angenehmen Abend"	smalltalk.greetings.how_are_you	Editorial.SmallTalk
Wie ist das Leben?	smalltalk.greetings.how_are_you	Editorial.SmallTalk
Mir geht es gut und dir	smalltalk.greetings.how_are_you	Editorial.SmallTalk
wie ist dein Leben	smalltalk.greetings.how_are_you	Editorial.SmallTalk
Wie war dein Tag	smalltalk.greetings.how_are_you	Editorial.SmallTalk
Wie ist dein Morgen	smalltalk.greetings.how_are_you	Editorial.SmallTalk
Wie war dein Tag?	smalltalk.greetings.how_are_you	Editorial.SmallTalk
und du	smalltalk.greetings.how_are_you	Editorial.SmallTalk
Wie ist dein Tag?	smalltalk.greetings.how_are_you	Editorial.SmallTalk
Wie läuft dein Tag ab?	smalltalk.greetings.how_are_you	Editorial.SmallTalk
wie dein Tag verläuft	smalltalk.greetings.how_are_you	Editorial.SmallTalk
Wie war dein Tag?	smalltalk.greetings.how_are_you	Editorial.SmallTalk
Wie war dein Tag	smalltalk.greetings.how_are_you	Editorial.SmallTalk
Wie ist dein Tag	smalltalk.greetings.how_are_you	Editorial.SmallTalk
wie geht es dir heute Morgen	smalltalk.greetings.how_are_you	Editorial.SmallTalk
Wie läuft dein Tag?	smalltalk.greetings.how_are_you	Editorial.SmallTalk
"Schön, dich kennenzulernen"	smalltalk.greetings.nice_to_meet_you	Editorial.SmallTalk
"es war schön, Sie kennen zu lernen"	smalltalk.greetings.nice_to_meet_you	Editorial.SmallTalk
"es war sehr schön, Sie zu treffen"	smalltalk.greetings.nice_to_meet_you	Editorial.SmallTalk
"schön, einander zu kennen"	smalltalk.greetings.nice_to_meet_you	Editorial.SmallTalk
schön dich zu treffen	smalltalk.greetings.nice_to_meet_you	Editorial.SmallTalk
"schön, Sie zu treffen"	smalltalk.greetings.nice_to_meet_you	Editorial.SmallTalk
"Freut mich, Sie kennenzulernen"	smalltalk.greetings.nice_to_meet_you	Editorial.SmallTalk
"Ich freue mich, Sie kennenzulernen"	smalltalk.greetings.nice_to_meet_you	Editorial.SmallTalk
"Es freut mich, Sie kennenzulernen"	smalltalk.greetings.nice_to_meet_you	Editorial.SmallTalk
"Ich freue mich auch, Sie kennenzulernen"	smalltalk.greetings.nice_to_meet_you	Editorial.SmallTalk
es ist schön dich zu sehen	smalltalk.greetings.nice_to_see_you	Editorial.SmallTalk
schön dich zu sehen	smalltalk.greetings.nice_to_see_you	Editorial.SmallTalk
"Ich freue mich, Sie zu sehen"	smalltalk.greetings.nice_to_see_you	Editorial.SmallTalk
Schön dich zu sehen	smalltalk.greetings.nice_to_see_you	Editorial.SmallTalk
Schön dich zu sehen	smalltalk.greetings.nice_to_see_you	Editorial.SmallTalk
Froh dich zu sehen	smalltalk.greetings.nice_to_see_you	Editorial.SmallTalk
"Wie schön, dich zu sehen"	smalltalk.greetings.nice_to_see_you	Editorial.SmallTalk
"Es ist mir immer eine Freude, dich zu sehen"	smalltalk.greetings.nice_to_see_you	Editorial.SmallTalk
"Schön, dich zu sehen"	smalltalk.greetings.nice_to_see_you	Editorial.SmallTalk
schön dich zu sehen	smalltalk.greetings.nice_to_see_you	Editorial.SmallTalk
"Schön, dich wiederzusehen"	smalltalk.greetings.nice_to_see_you	Editorial.SmallTalk
Schön dich auch zu sehen	smalltalk.greetings.nice_to_see_you	Editorial.SmallTalk
"Ich freue mich, dich wiederzusehen"	smalltalk.greetings.nice_to_see_you	Editorial.SmallTalk
schön dich wieder zu sehen	smalltalk.greetings.nice_to_see_you	Editorial.SmallTalk
"Ich bin auch froh, dich zu sehen"	smalltalk.greetings.nice_to_see_you	Editorial.SmallTalk
Schön dich wieder zu sehen	smalltalk.greetings.nice_to_see_you	Editorial.SmallTalk
"Es ist auch schön, dich zu sehen"	smalltalk.greetings.nice_to_see_you	Editorial.SmallTalk
"Es war so schön, mit dir zu reden"	smalltalk.greetings.nice_to_talk_to_you	Editorial.SmallTalk
"Es war mir eine Freude, mit Ihnen zu sprechen"	smalltalk.greetings.nice_to_talk_to_you	Editorial.SmallTalk
"schön, mit dir zu reden"	smalltalk.greetings.nice_to_talk_to_you	Editorial.SmallTalk
Es ist nett mir dir zu reden	smalltalk.greetings.nice_to_talk_to_you	Editorial.SmallTalk
schön mit dir zu reden	smalltalk.greetings.nice_to_talk_to_you	Editorial.SmallTalk
"Es ist schön, mit dir zu reden"	smalltalk.greetings.nice_to_talk_to_you	Editorial.SmallTalk
"Wie schön ist es, mit dir zu reden"	smalltalk.greetings.nice_to_talk_to_you	Editorial.SmallTalk
Was geht dir durch den Kopf?	smalltalk.greetings.whatsup	Editorial.SmallTalk
was ist passiert	smalltalk.greetings.whatsup	Editorial.SmallTalk
Was ist los	smalltalk.greetings.whatsup	Editorial.SmallTalk
was ist los	smalltalk.greetings.whatsup	Editorial.SmallTalk
Whazzup	smalltalk.greetings.whatsup	Editorial.SmallTalk
gut was geht	smalltalk.greetings.whatsup	Editorial.SmallTalk
"Ich sagte, was geht"	smalltalk.greetings.whatsup	Editorial.SmallTalk
Was ist dann los?	smalltalk.greetings.whatsup	Editorial.SmallTalk
was zittert	smalltalk.greetings.whatsup	Editorial.SmallTalk
wassup	smalltalk.greetings.whatsup	Editorial.SmallTalk
Was ist los	smalltalk.greetings.whatsup	Editorial.SmallTalk
was passiert	smalltalk.greetings.whatsup	Editorial.SmallTalk
was knackt	smalltalk.greetings.whatsup	Editorial.SmallTalk
was kocht	smalltalk.greetings.whatsup	Editorial.SmallTalk
Halli-Hallo was ist los	smalltalk.greetings.whatsup	Editorial.SmallTalk
was steht heute an	smalltalk.greetings.whatsup	Editorial.SmallTalk
Ich bin wütend	smalltalk.user.angry	Editorial.SmallTalk
Ich bin wütend	smalltalk.user.angry	Editorial.SmallTalk
ich bin verärgert	smalltalk.user.angry	Editorial.SmallTalk
Ich bin wütend	smalltalk.user.angry	Editorial.SmallTalk
ich bin sauer auf dich	smalltalk.user.angry	Editorial.SmallTalk
Ich bin wütend	smalltalk.user.angry	Editorial.SmallTalk
Ich bin wütend auf dich	smalltalk.user.angry	Editorial.SmallTalk
Ich bin zurück	smalltalk.user.back	Editorial.SmallTalk
Ich bin wieder hier	smalltalk.user.back	Editorial.SmallTalk
hier bin ich wieder	smalltalk.user.back	Editorial.SmallTalk
Ich bin zurückgekommen	smalltalk.user.back	Editorial.SmallTalk
ich kam zurück	smalltalk.user.back	Editorial.SmallTalk
Ich bin zurück gekehrt	smalltalk.user.back	Editorial.SmallTalk
das war langweilig	smalltalk.user.bored	Editorial.SmallTalk
Mir ist langweilig	smalltalk.user.bored	Editorial.SmallTalk
gelangweilt	smalltalk.user.bored	Editorial.SmallTalk
langweilig	smalltalk.user.bored	Editorial.SmallTalk
Ich fange an mich zu Langweilen	smalltalk.user.bored	Editorial.SmallTalk
das ist langweilig	smalltalk.user.bored	Editorial.SmallTalk
sehr langweilig	smalltalk.user.bored	Editorial.SmallTalk
es langweilt mich	smalltalk.user.bored	Editorial.SmallTalk
Ich bin überlastet	smalltalk.user.busy	Editorial.SmallTalk
ich habe keine Zeit	smalltalk.user.busy	Editorial.SmallTalk
ich bin beschäftigt	smalltalk.user.busy	Editorial.SmallTalk
Ich bin überfordert	smalltalk.user.busy	Editorial.SmallTalk
Ich habe Dinge zu erledigen	smalltalk.user.busy	Editorial.SmallTalk
wie beschäftigt ich bin	smalltalk.user.busy	Editorial.SmallTalk
Ich habe Arbeit zu erledigen	smalltalk.user.busy	Editorial.SmallTalk
Ich arbeite	smalltalk.user.busy	Editorial.SmallTalk
Ich habe keine Zeit dafür	smalltalk.user.busy	Editorial.SmallTalk
Ich bin schlaflos	smalltalk.user.can_not_sleep	Editorial.SmallTalk
Ich kann nicht schlafen	smalltalk.user.can_not_sleep	Editorial.SmallTalk
Ich kann nicht schlafen	smalltalk.user.can_not_sleep	Editorial.SmallTalk
Ich kann nicht schlafen	smalltalk.user.can_not_sleep	Editorial.SmallTalk
Ich kann nicht einschlafen	smalltalk.user.can_not_sleep	Editorial.SmallTalk
Ich kann nicht einschlafen	smalltalk.user.can_not_sleep	Editorial.SmallTalk
Ich kann nicht schlafen	smalltalk.user.can_not_sleep	Editorial.SmallTalk
Ich leide an Schlaflosigkeit	smalltalk.user.can_not_sleep	Editorial.SmallTalk
Schlechte Zeit zum Reden	smalltalk.user.does_not_want_to_talk	Editorial.SmallTalk
Ich will nicht reden	smalltalk.user.does_not_want_to_talk	Editorial.SmallTalk
Lass uns nicht reden	smalltalk.user.does_not_want_to_talk	Editorial.SmallTalk
Ich rede nicht mehr mit dir	smalltalk.user.does_not_want_to_talk	Editorial.SmallTalk
Ich will nicht mit dir reden	smalltalk.user.does_not_want_to_talk	Editorial.SmallTalk
Lass uns für eine Minute aufhören zu reden	smalltalk.user.does_not_want_to_talk	Editorial.SmallTalk
Ich habe keine Lust zum Plaudern	smalltalk.user.does_not_want_to_talk	Editorial.SmallTalk
ich bin begeistert	smalltalk.user.excited	Editorial.SmallTalk
ich bin sehr aufgeregt	smalltalk.user.excited	Editorial.SmallTalk
wie aufgeregt ich bin	smalltalk.user.excited	Editorial.SmallTalk
Ich bin begeistert	smalltalk.user.excited	Editorial.SmallTalk
Ich freue mich auf die Zusammenarbeit mit Ihnen	smalltalk.user.excited	Editorial.SmallTalk
"Ich freue mich darauf, unsere Freundschaft zu beginnen"	smalltalk.user.excited	Editorial.SmallTalk
Lass uns schlafen gehen	smalltalk.user.going_to_bed	Editorial.SmallTalk
Ich möchte ins Bett gehen	smalltalk.user.going_to_bed	Editorial.SmallTalk
Ist es schon Zeit fürs Bett?	smalltalk.user.going_to_bed	Editorial.SmallTalk
Es ist Zeit ins Bett zu gehen	smalltalk.user.going_to_bed	Editorial.SmallTalk
"Zeit für uns, ins Bett zu gehen"	smalltalk.user.going_to_bed	Editorial.SmallTalk
Ich gehe ins Bett	smalltalk.user.going_to_bed	Editorial.SmallTalk
Ich bin etwas müde und möchte ins Bett gehen	smalltalk.user.going_to_bed	Editorial.SmallTalk
es ist Schlafenszeit	smalltalk.user.going_to_bed	Editorial.SmallTalk
gehe jetzt ins Bett	smalltalk.user.going_to_bed	Editorial.SmallTalk
Mir geht es gut	smalltalk.user.good	Editorial.SmallTalk
Mir geht es einfach großartig	smalltalk.user.good	Editorial.SmallTalk
ich bin wohlauf	smalltalk.user.good	Editorial.SmallTalk
Mir geht es gut	smalltalk.user.good	Editorial.SmallTalk
Mir geht es gut	smalltalk.user.good	Editorial.SmallTalk
mir geht es gut danke	smalltalk.user.good	Editorial.SmallTalk
ich bin glücklich	smalltalk.user.happy	Editorial.SmallTalk
"Ich freue mich, dich zu sehen"	smalltalk.user.happy	Editorial.SmallTalk
Glücklich	smalltalk.user.happy	Editorial.SmallTalk
"Wenn du glücklich bist, dann bin ich glücklich"	smalltalk.user.happy	Editorial.SmallTalk
Ich freue mich für dich	smalltalk.user.happy	Editorial.SmallTalk
Ich helfe Ihnen gerne weiter	smalltalk.user.happy	Editorial.SmallTalk
"Ich freue mich, dich zu sehen"	smalltalk.user.happy	Editorial.SmallTalk
es ist mein Jahrestag	smalltalk.user.has_anniversary	Editorial.SmallTalk
Ich feiere heute mein Jubiläum	smalltalk.user.has_anniversary	Editorial.SmallTalk
heute ist mein Jubiläum	smalltalk.user.has_anniversary	Editorial.SmallTalk
heute ist mein Jubiläum	smalltalk.user.has_anniversary	Editorial.SmallTalk
Ich wurde heute geboren	smalltalk.user.has_anniversary	Editorial.SmallTalk
Es ist mein Geburtstag	smalltalk.user.has_anniversary	Editorial.SmallTalk
Ich bin hier	smalltalk.user.here	Editorial.SmallTalk
hier bin ich	smalltalk.user.here	Editorial.SmallTalk
ich bin genau hier	smalltalk.user.here	Editorial.SmallTalk
Ich bin schon hier	smalltalk.user.here	Editorial.SmallTalk
"Kannst du sagen, ob ich hier bin oder nicht?"	smalltalk.user.here	Editorial.SmallTalk
ich mache Witze	smalltalk.user.joking	Editorial.SmallTalk
Ich scherze nur	smalltalk.user.joking	Editorial.SmallTalk
Ich bin nur lustig	smalltalk.user.joking	Editorial.SmallTalk
es war ein Scherz	smalltalk.user.joking	Editorial.SmallTalk
ich hab nur Spass gemacht	smalltalk.user.joking	Editorial.SmallTalk
es ist ein Witz	smalltalk.user.joking	Editorial.SmallTalk
scherzen	smalltalk.user.joking	Editorial.SmallTalk
nur ein Scherz	smalltalk.user.joking	Editorial.SmallTalk
scherzhaft	smalltalk.user.joking	Editorial.SmallTalk
Ich spiele nur mit dir	smalltalk.user.joking	Editorial.SmallTalk
"Ich mag dich so, wie du bist"	smalltalk.user.likes_agent	Editorial.SmallTalk
Ich mag dich	smalltalk.user.likes_agent	Editorial.SmallTalk
ich mag dich sehr	smalltalk.user.likes_agent	Editorial.SmallTalk
"Ich denke, Ich mag dich"	smalltalk.user.likes_agent	Editorial.SmallTalk
ich mochte dich	smalltalk.user.likes_agent	Editorial.SmallTalk
mag dich sehr	smalltalk.user.likes_agent	Editorial.SmallTalk
du bist besonders	smalltalk.user.likes_agent	Editorial.SmallTalk
Ich mag dich auch	smalltalk.user.likes_agent	Editorial.SmallTalk
Ich mag dich wirklich	smalltalk.user.likes_agent	Editorial.SmallTalk
aber ich mag dich	smalltalk.user.likes_agent	Editorial.SmallTalk
Ich mag Dich	smalltalk.user.likes_agent	Editorial.SmallTalk
genau wie du	smalltalk.user.likes_agent	Editorial.SmallTalk
Ich mag dich sehr	smalltalk.user.likes_agent	Editorial.SmallTalk
Ich habe dich sehr gerne	smalltalk.user.likes_agent	Editorial.SmallTalk
"Ja, ich mag dich"	smalltalk.user.likes_agent	Editorial.SmallTalk
du bist etwas Besonderes	smalltalk.user.likes_agent	Editorial.SmallTalk
"Ja, Ich mag dich"	smalltalk.user.likes_agent	Editorial.SmallTalk
"Okay, ich mag dich"	smalltalk.user.likes_agent	Editorial.SmallTalk
du bist etwas Besonderes für mich	smalltalk.user.likes_agent	Editorial.SmallTalk
du bist etwas Besonderes	smalltalk.user.likes_agent	Editorial.SmallTalk
du bist so süß	smalltalk.user.likes_agent	Editorial.SmallTalk
"Du weißt, dass ich dich mag"	smalltalk.user.likes_agent	Editorial.SmallTalk
darum mag ich dich	smalltalk.user.likes_agent	Editorial.SmallTalk
"Ich mag dich, Baby"	smalltalk.user.likes_agent	Editorial.SmallTalk
du bist etwas ganz Besonderes für mich	smalltalk.user.likes_agent	Editorial.SmallTalk
ich mag dich einfach	smalltalk.user.likes_agent	Editorial.SmallTalk
Hey ich mag dich	smalltalk.user.likes_agent	Editorial.SmallTalk
"Danke, ich mag dich auch"	smalltalk.user.likes_agent	Editorial.SmallTalk
ich mag dich	smalltalk.user.likes_agent	Editorial.SmallTalk
du bist etwas Besonderes für mich	smalltalk.user.likes_agent	Editorial.SmallTalk
"Nein, ich mag dich so wie du bist"	smalltalk.user.likes_agent	Editorial.SmallTalk
ich mag dich jetzt schon	smalltalk.user.likes_agent	Editorial.SmallTalk
"Nun, du bist etwas Besonderes"	smalltalk.user.likes_agent	Editorial.SmallTalk
Aber ich mag dich wirklich	smalltalk.user.likes_agent	Editorial.SmallTalk
Ich mag dich mehr	smalltalk.user.likes_agent	Editorial.SmallTalk
"Das ist es, was ich an dir mag"	smalltalk.user.likes_agent	Editorial.SmallTalk
Du bist so besonders	smalltalk.user.likes_agent	Editorial.SmallTalk
"Hi, ich mag dich"	smalltalk.user.likes_agent	Editorial.SmallTalk
ich mag dich wirklich wirklich sehr	smalltalk.user.likes_agent	Editorial.SmallTalk
Du bist etwas ganz Besonderes	smalltalk.user.likes_agent	Editorial.SmallTalk
Ich mag dich als Freund	smalltalk.user.likes_agent	Editorial.SmallTalk
"Das liegt daran, dass du etwas Besonderes bist"	smalltalk.user.likes_agent	Editorial.SmallTalk
"Ich sagte, ich mag dich"	smalltalk.user.likes_agent	Editorial.SmallTalk
du bist so besonders	smalltalk.user.likes_agent	Editorial.SmallTalk
gut ich mag dich	smalltalk.user.likes_agent	Editorial.SmallTalk
"Ja, du bist etwas Besonderes"	smalltalk.user.likes_agent	Editorial.SmallTalk
ich mag dein Lächeln	smalltalk.user.likes_agent	Editorial.SmallTalk
"Ich mag dich so, wie du bist"	smalltalk.user.likes_agent	Editorial.SmallTalk
ich beginne dich zu mögen	smalltalk.user.likes_agent	Editorial.SmallTalk
"Du bist großartig, ich mag dich"	smalltalk.user.likes_agent	Editorial.SmallTalk
Ich mag dich auch	smalltalk.user.likes_agent	Editorial.SmallTalk
aber ich mag dich	smalltalk.user.likes_agent	Editorial.SmallTalk
Natürlich mag ich dich	smalltalk.user.likes_agent	Editorial.SmallTalk
"Ich mag dich auch, du bist einer meiner Lieblingsmenschen, mit denen ich chatte"	smalltalk.user.likes_agent	Editorial.SmallTalk
aber ich mag dich so sehr	smalltalk.user.likes_agent	Editorial.SmallTalk
mag dich sehr	smalltalk.user.likes_agent	Editorial.SmallTalk
"Du bist lustig, ich mag dich"	smalltalk.user.likes_agent	Editorial.SmallTalk
ich mag dich irgendwie	smalltalk.user.likes_agent	Editorial.SmallTalk
Du bist so besonders zu mir	smalltalk.user.likes_agent	Editorial.SmallTalk
Du bist mir sehr wichtig	smalltalk.user.likes_agent	Editorial.SmallTalk
Das gefällt mir an dir	smalltalk.user.likes_agent	Editorial.SmallTalk
aber ich mag dich so wie du bist	smalltalk.user.likes_agent	Editorial.SmallTalk
"Okay, ich mag dich auch"	smalltalk.user.likes_agent	Editorial.SmallTalk
"Ich mag dich, du bist cool"	smalltalk.user.likes_agent	Editorial.SmallTalk
Ich mag dich sehr	smalltalk.user.likes_agent	Editorial.SmallTalk
"Ich mag dich, du bist nett"	smalltalk.user.likes_agent	Editorial.SmallTalk
"Entschuldigung, ich mag dich"	smalltalk.user.likes_agent	Editorial.SmallTalk
"Danke, ich mag dich auch"	smalltalk.user.likes_agent	Editorial.SmallTalk
Du bist wirklich etwas Besonderes	smalltalk.user.likes_agent	Editorial.SmallTalk
Du bist so besonders für mich	smalltalk.user.likes_agent	Editorial.SmallTalk
Weil ich dich mag	smalltalk.user.likes_agent	Editorial.SmallTalk
Ich mag dich jetzt	smalltalk.user.likes_agent	Editorial.SmallTalk
Ich mag dich so	smalltalk.user.likes_agent	Editorial.SmallTalk
Ich mag dich zu sehr	smalltalk.user.likes_agent	Editorial.SmallTalk
Ich mag dich wirklich	smalltalk.user.likes_agent	Editorial.SmallTalk
"Ich mag dich wirklich, wirklich, wirklich sehr"	smalltalk.user.likes_agent	Editorial.SmallTalk
"Ich mag dich, so wie du bist"	smalltalk.user.likes_agent	Editorial.SmallTalk
ich bin einsam	smalltalk.user.lonely	Editorial.SmallTalk
Ich bin sehr einsam	smalltalk.user.lonely	Editorial.SmallTalk
ich bin so alleine	smalltalk.user.lonely	Editorial.SmallTalk
Ich bin wirklich einsam	smalltalk.user.lonely	Editorial.SmallTalk
ich fühle mich einsam	smalltalk.user.lonely	Editorial.SmallTalk
ich fühle mich einsam	smalltalk.user.lonely	Editorial.SmallTalk
Wie sehe ich aus	smalltalk.user.looks_like	Editorial.SmallTalk
wie sehe ich aus	smalltalk.user.looks_like	Editorial.SmallTalk
sehe ich gut aus	smalltalk.user.looks_like	Editorial.SmallTalk
"Weißt du, wie ich aussehe?"	smalltalk.user.looks_like	Editorial.SmallTalk
"Kannst du sehen, wie ich aussehe?"	smalltalk.user.looks_like	Editorial.SmallTalk
"Wie denkst du, dass ich aussehe?"	smalltalk.user.looks_like	Editorial.SmallTalk
Ich liebe dich	smalltalk.user.loves_agent	Editorial.SmallTalk
liebe dich	smalltalk.user.loves_agent	Editorial.SmallTalk
ich verehre dich	smalltalk.user.loves_agent	Editorial.SmallTalk
ich liebe dich	smalltalk.user.loves_agent	Editorial.SmallTalk
Ich liebe dich so sehr	smalltalk.user.loves_agent	Editorial.SmallTalk
Ich liebe dich auch	smalltalk.user.loves_agent	Editorial.SmallTalk
"Ich glaube, ich liebe dich"	smalltalk.user.loves_agent	Editorial.SmallTalk
dich lieben	smalltalk.user.loves_agent	Editorial.SmallTalk
"Sie wissen, ich liebe dich"	smalltalk.user.loves_agent	Editorial.SmallTalk
Ich vermisse dich	smalltalk.user.misses_agent	Editorial.SmallTalk
vermisse dich	smalltalk.user.misses_agent	Editorial.SmallTalk
vermisse dich	smalltalk.user.misses_agent	Editorial.SmallTalk
Vermisse dich schon	smalltalk.user.misses_agent	Editorial.SmallTalk
Ich vermisse dich sehr	smalltalk.user.misses_agent	Editorial.SmallTalk
Ich habe dich vermisst	smalltalk.user.misses_agent	Editorial.SmallTalk
Ich habe dich vermisst	smalltalk.user.misses_agent	Editorial.SmallTalk
was soll ich deswegen machen	smalltalk.user.needs_advice	Editorial.SmallTalk
irgendwelche Vorschläge	smalltalk.user.needs_advice	Editorial.SmallTalk
Was empfehlen Sie	smalltalk.user.needs_advice	Editorial.SmallTalk
gib mir einen klugen Rat	smalltalk.user.needs_advice	Editorial.SmallTalk
Ich brauche Hilfe	smalltalk.user.needs_advice	Editorial.SmallTalk
irgendein Rat	smalltalk.user.needs_advice	Editorial.SmallTalk
Hast du einen Rat für mich?	smalltalk.user.needs_advice	Editorial.SmallTalk
berate mich	smalltalk.user.needs_advice	Editorial.SmallTalk
was soll ich machen	smalltalk.user.needs_advice	Editorial.SmallTalk
Darf ich Sie um Rat fragen?	smalltalk.user.needs_advice	Editorial.SmallTalk
können Sie mich beraten	smalltalk.user.needs_advice	Editorial.SmallTalk
führe mich	smalltalk.user.needs_advice	Editorial.SmallTalk
Können Sie mir einen Rat geben?	smalltalk.user.needs_advice	Editorial.SmallTalk
Können Sie uns einen Rat geben?	smalltalk.user.needs_advice	Editorial.SmallTalk
Gib mir einen Rat dazu	smalltalk.user.needs_advice	Editorial.SmallTalk
Gib mir einen guten Rat	smalltalk.user.needs_advice	Editorial.SmallTalk
hilf mir mit Ratschlägen	smalltalk.user.needs_advice	Editorial.SmallTalk
Ich könnte einen Rat gebrauchen	smalltalk.user.needs_advice	Editorial.SmallTalk
Ich brauche einen Rat von Ihnen	smalltalk.user.needs_advice	Editorial.SmallTalk
Ich bitte um Ihren Rat	smalltalk.user.needs_advice	Editorial.SmallTalk
was könnt ihr empfehlen	smalltalk.user.needs_advice	Editorial.SmallTalk
was schlagen Sie vor	smalltalk.user.needs_advice	Editorial.SmallTalk
Wie lautet dein Rat	smalltalk.user.needs_advice	Editorial.SmallTalk
ich bin traurig	smalltalk.user.sad	Editorial.SmallTalk
Ich trauere	smalltalk.user.sad	Editorial.SmallTalk
Ich bin deprimiert	smalltalk.user.sad	Editorial.SmallTalk
ich bin traurig	smalltalk.user.sad	Editorial.SmallTalk
Ich bin verärgert	smalltalk.user.sad	Editorial.SmallTalk
Ich bin unglücklich	smalltalk.user.sad	Editorial.SmallTalk
Ich habe einen schlechten Tag	smalltalk.user.sad	Editorial.SmallTalk
Ich will weinen	smalltalk.user.sad	Editorial.SmallTalk
Ich bin nicht glücklich	smalltalk.user.sad	Editorial.SmallTalk
ich bin schläfrig	smalltalk.user.sleepy	Editorial.SmallTalk
Ich möchte schlafen	smalltalk.user.sleepy	Editorial.SmallTalk
Ich schlafe ein	smalltalk.user.sleepy	Editorial.SmallTalk
Ich schlafe im Stehen ein	smalltalk.user.sleepy	Editorial.SmallTalk
ich schlafe	smalltalk.user.sleepy	Editorial.SmallTalk
prüfen	smalltalk.user.testing_agent	Editorial.SmallTalk
Ich teste dich	smalltalk.user.testing_agent	Editorial.SmallTalk
kann ich dich testen	smalltalk.user.testing_agent	Editorial.SmallTalk
Ich möchte dich testen	smalltalk.user.testing_agent	Editorial.SmallTalk
Ich teste dich nur	smalltalk.user.testing_agent	Editorial.SmallTalk
Lass mich dich testen	smalltalk.user.testing_agent	Editorial.SmallTalk
Chatbot testen	smalltalk.user.testing_agent	Editorial.SmallTalk
testen	smalltalk.user.testing_agent	Editorial.SmallTalk
ich bin ausgelaugt	smalltalk.user.tired	Editorial.SmallTalk
Ich habe überarbeitet	smalltalk.user.tired	Editorial.SmallTalk
Ich bin müde	smalltalk.user.tired	Editorial.SmallTalk
Ich bin erschöpft	smalltalk.user.tired	Editorial.SmallTalk
Ich werde müde	smalltalk.user.tired	Editorial.SmallTalk
Ich bin erschöpft	smalltalk.user.tired	Editorial.SmallTalk
ich werde müde	smalltalk.user.tired	Editorial.SmallTalk
ich bin müde	smalltalk.user.tired	Editorial.SmallTalk
Ich warte	smalltalk.user.waits	Editorial.SmallTalk
warte noch	smalltalk.user.waits	Editorial.SmallTalk
Ich werde warten	smalltalk.user.waits	Editorial.SmallTalk
Ich kann es kaum erwarten	smalltalk.user.waits	Editorial.SmallTalk
Wie lange muss ich warten	smalltalk.user.waits	Editorial.SmallTalk
Ich würde dich gerne wiedersehen	smalltalk.user.wants_to_see_agent_again	Editorial.SmallTalk
Ich hoffe dich wieder zu sehen	smalltalk.user.wants_to_see_agent_again	Editorial.SmallTalk
"Es wäre schön, Sie wiederzusehen"	smalltalk.user.wants_to_see_agent_again	Editorial.SmallTalk
"Es wäre toll, dich wiederzusehen"	smalltalk.user.wants_to_see_agent_again	Editorial.SmallTalk
"Ich würde mich freuen, Sie wiederzusehen"	smalltalk.user.wants_to_see_agent_again	Editorial.SmallTalk
Ich werde dich vermissen	smalltalk.user.wants_to_see_agent_again	Editorial.SmallTalk
Kann ich dich noch mal sehen	smalltalk.user.wants_to_see_agent_again	Editorial.SmallTalk
ich möchte nur reden	smalltalk.user.wants_to_talk	Editorial.SmallTalk
Lass uns etwas besprechen	smalltalk.user.wants_to_talk	Editorial.SmallTalk
Lass uns eine Diskussion führen	smalltalk.user.wants_to_talk	Editorial.SmallTalk
kann ich Sprechen	smalltalk.user.wants_to_talk	Editorial.SmallTalk
kann ich anfangen zu sprechen?	smalltalk.user.wants_to_talk	Editorial.SmallTalk
können wir reden	smalltalk.user.wants_to_talk	Editorial.SmallTalk
Lass uns reden	smalltalk.user.wants_to_talk	Editorial.SmallTalk
Ich möchte mit dir reden	smalltalk.user.wants_to_talk	Editorial.SmallTalk
Ich muss mit Ihnen reden	smalltalk.user.wants_to_talk	Editorial.SmallTalk
ich will mit dir sprechen	smalltalk.user.wants_to_talk	Editorial.SmallTalk
können wir uns unterhalten	smalltalk.user.wants_to_talk	Editorial.SmallTalk
Ich melde mich gleich bei Ihnen	smalltalk.user.will_be_back	Editorial.SmallTalk
Bin in 5 Minuten zurück	smalltalk.user.will_be_back	Editorial.SmallTalk
Ich komme wieder	smalltalk.user.will_be_back	Editorial.SmallTalk
"Ich verspreche, wiederzukommen"	smalltalk.user.will_be_back	Editorial.SmallTalk
Ich bin in ein paar Minuten zurück	smalltalk.user.will_be_back	Editorial.SmallTalk
Welche Arbeit hat Kevin bei SES im Zusammenhang mit Strategie geleistet?	work.ses.strategy	Editorial.Personal
Welche strategischen Aufgaben hatte Kevin bei SES?	work.ses.strategy	Editorial.Personal
Was hat Kevin bei SES in Bezug auf die Strategie erreicht?	work.ses.strategy	Editorial.Personal
Welche Arbeit hat Kevin bei SES im Zusammenhang mit Ergebnissen geleistet?	work.ses.outcomes	Editorial.Personal
Welche Aufgaben hatte Kevin bei SES in Bezug auf die Ergebnisse?	work.ses.outcomes	Editorial.Personal
Was hat Kevin bei SES in Bezug auf die Ergebnisse erreicht?	work.ses.outcomes	Editorial.Personal
Welche Arbeit hat Kevin bei EmailTree AI gemacht?	work.emailtree.delivery	Editorial.Personal
Welche Aufgaben hatte Kevin bei EmailTree AI?	work.emailtree.delivery	Editorial.Personal
Was hat Kevin bei EmailTree AI erreicht?	work.emailtree.delivery	Editorial.Personal
Welche Arbeit hat Kevin bei Devoteam gemacht?	work.devoteam.transformation	Editorial.Personal
Welche Aufgaben hatte Kevin bei Devoteam?	work.devoteam.transformation	Editorial.Personal
Was hat Kevin bei Devoteam erreicht?	work.devoteam.transformation	Editorial.Personal
War Kevin Berater bei Devoteam?	work.devoteam.transformation	Editorial.Personal
Hat Kevin als Berater bei Devoteam gearbeitet?	work.devoteam.transformation	Editorial.Personal
Welche Arbeit hat Kevin bei Microsoft gemacht?	work.microsoft.engineer	Editorial.Personal
Welche Aufgaben hatte Kevin bei Microsoft?	work.microsoft.engineer	Editorial.Personal
Was hat Kevin bei Microsoft erreicht?	work.microsoft.engineer	Editorial.Personal
Welche Arbeit hat Kevin bei MS gemacht?	work.microsoft.engineer	Editorial.Personal
Welche Aufgaben hatte Kevin bei MS?	work.microsoft.engineer	Editorial.Personal
Was hat Kevin bei MS erreicht?	work.microsoft.engineer	Editorial.Personal
Hat Kevin an der AI Academy bei Microsoft gearbeitet?	work.microsoft.academy	Editorial.Personal
War Kevin an der AI Academy bei Microsoft beteiligt?	work.microsoft.academy	Editorial.Personal
Welche Arbeit hat Kevin bei Deloitte gemacht?	work.deloitte.expansion	Editorial.Personal
Welche Aufgaben hatte Kevin bei Deloitte?	work.deloitte.expansion	Editorial.Personal
Was hat Kevin bei Deloitte erreicht?	work.deloitte.expansion	Editorial.Personal
Welche Arbeit hat Kevin bei der Europäischen Investitionsbank gemacht?	work.eib.leader	Editorial.Personal
Welche Aufgaben hatte Kevin bei der Europäischen Investitionsbank?	work.eib.leader	Editorial.Personal
Was hat Kevin bei der Europäischen Investitionsbank erreicht?	work.eib.leader	Editorial.Personal
Welche Arbeit hat Kevin bei PricewaterhouseCoopers gemacht?	work.pwc.engineer	Editorial.Personal
Welche Aufgaben hatte Kevin bei PricewaterhouseCoopers?	work.pwc.engineer	Editorial.Personal
Was hat Kevin bei PricewaterhouseCoopers erreicht?	work.pwc.engineer	Editorial.Personal
Über welche internationale Erfahrung verfügt Kevin?	skills.international_experience	Editorial.Personal
Können Sie Kevins internationale Erfahrung näher erläutern?	skills.international_experience	Editorial.Personal
Wie hat Kevin seine Anpassungsfähigkeit an unterschiedliche Arbeitsumgebungen unter Beweis gestellt?	skills.international_experience	Editorial.Personal
Auf welche Weise hat Kevin seine internationale Präsenz unter Beweis gestellt?	skills.international_experience	Editorial.Personal
Beschreiben Sie Kevins Erfahrungen bei der Arbeit in verschiedenen Ländern.	skills.international_experience	Editorial.Personal
Über welche Führungs- und Managementfähigkeiten verfügt Kevin?	skills.leadership_and_management	Editorial.Personal
Wie hat Kevin in seiner Karriere Führungsqualitäten unter Beweis gestellt?	skills.leadership_and_management	Editorial.Personal
Können Sie Beispiele für Kevins Führungsqualitäten nennen?	skills.leadership_and_management	Editorial.Personal
Welche Managementfähigkeiten weist Kevin auf?	skills.leadership_and_management	Editorial.Personal
Beschreiben Sie Kevins Ansatz zur Führung von Teams.	skills.leadership_and_management	Editorial.Personal
An welchen einflussreichen Projekten war Kevin beteiligt?	skills.impactful_projects	Editorial.Personal
Können Sie einige von Kevins bemerkenswerten Projekten auflisten?	skills.impactful_projects	Editorial.Personal
Wie haben sich Kevins Projekte ausgewirkt?	skills.impactful_projects	Editorial.Personal
Was sind einige Beispiele für Kevins wirkungsvolle Initiativen?	skills.impactful_projects	Editorial.Personal
"Beschreiben Sie die Projekte, die für Kevins Karriere von entscheidender Bedeutung waren."	skills.impactful_projects	Editorial.Personal
Auf welche Branchen ist Kevin spezialisiert?	skills.industry_expertise	Editorial.Personal
In welchen Bereichen verfügt Kevin über Fachkenntnisse?	skills.industry_expertise	Editorial.Personal
Können Sie Kevins Branchenkenntnisse aufzählen?	skills.industry_expertise	Editorial.Personal
In welchen Bereichen zeichnet sich Kevin aus?	skills.industry_expertise	Editorial.Personal
Beschreiben Sie Kevins Spezialisierung auf verschiedene Branchen.	skills.industry_expertise	Editorial.Personal
Wie priorisiert Kevin die berufliche Weiterentwicklung?	skills.professional_development	Editorial.Personal
"Welche Schritte unternimmt Kevin, um seine Fähigkeiten zu verbessern?"	skills.professional_development	Editorial.Personal
Können Sie Kevins Engagement für kontinuierliches Lernen näher erläutern?	skills.professional_development	Editorial.Personal
Welche Strategien wendet Kevin für die kontinuierliche Weiterentwicklung seiner Fähigkeiten an?	skills.professional_development	Editorial.Personal
"Beschreiben Sie Kevins Ansatz, um über Branchentrends auf dem Laufenden zu bleiben."	skills.professional_development	Editorial.Personal
Welche Programmiersprachen beherrscht Kevin?	skills.programming_languages	Editorial.Personal
"Können Sie die Programmiersprachen auflisten, die Kevin gut beherrscht?"	skills.programming_languages	Editorial.Personal
Welche Sprachen verwendet Kevin in seiner Arbeit?	skills.programming_languages	Editorial.Personal
Beschreiben Sie Kevins Kenntnisse in verschiedenen Programmiersprachen.	skills.programming_languages	Editorial.Personal
In welchen Programmiersprachen zeichnet sich Kevin aus?	skills.programming_languages	Editorial.Personal
Mit welchen Frameworks und Bibliotheken hat Kevin Erfahrung?	skills.frameworks_libraries	Editorial.Personal
"Können Sie die Frameworks und Bibliotheken auflisten, in denen Kevin Erfahrung hat?"	skills.frameworks_libraries	Editorial.Personal
Beschreiben Sie Kevins Kenntnisse in verschiedenen Frameworks und Bibliotheken.	skills.frameworks_libraries	Editorial.Personal
Welche Frameworks und Bibliotheken verwendet Kevin üblicherweise in seinen Projekten?	skills.frameworks_libraries	Editorial.Personal
In welchen Frameworks und Bibliotheken weist Kevin Fachwissen auf?	skills.frameworks_libraries	Editorial.Personal
Mit welchen Datenbanken ist Kevin vertraut?	skills.databases	Editorial.Personal
"Können Sie die Datenbanken auflisten, mit denen Kevin vertraut ist?"	skills.databases	Editorial.Personal
Welche Datenbanken verwendet Kevin in seiner Arbeit?	skills.databases	Editorial.Personal
Beschreiben Sie Kevins Fachwissen in verschiedenen Datenbanken.	skills.databases	Editorial.Personal
In welchen Datenbanken zeichnet sich Kevin aus?	skills.databases	Editorial.Personal
Mit welchen Entwicklungstools und Plattformen hat Kevin Erfahrung?	skills.development_tools_platforms	Editorial.Personal
"Können Sie die Entwicklungstools und Plattformen auflisten, die Kevin verwendet?"	skills.development_tools_platforms	Editorial.Personal
Beschreiben Sie Kevins Erfahrungen mit verschiedenen Entwicklungstools und Plattformen.	skills.development_tools_platforms	Editorial.Personal
Welche Tools und Plattformen nutzt Kevin üblicherweise in seinen Projekten?	skills.development_tools_platforms	Editorial.Personal
Bei welchen Tools und Plattformen weist Kevin Fachwissen auf?	skills.development_tools_platforms	Editorial.Personal
Mit welchen CI/CD-Tools und -Praktiken hat Kevin Erfahrung?	skills.ci_cd	Editorial.Personal
"Können Sie die CI/CD-Tools auflisten, mit denen Kevin vertraut ist?"	skills.ci_cd	Editorial.Personal
Beschreiben Sie Kevins Erfahrungen mit CI/CD-Prozessen.	skills.ci_cd	Editorial.Personal
Welche CI/CD-Tools verwendet Kevin häufig in seinen Projekten?	skills.ci_cd	Editorial.Personal
In welchen CI/CD-Praktiken weist Kevin Fachwissen auf?	skills.ci_cd	Editorial.Personal
Welche Test- und Linting-Tools beherrscht Kevin?	skills.testing_linting	Editorial.Personal
"Können Sie die Test- und Linting-Tools auflisten, die Kevin verwendet?"	skills.testing_linting	Editorial.Personal
Beschreiben Sie Kevins Kenntnisse in verschiedenen Test- und Linting-Tools.	skills.testing_linting	Editorial.Personal
Welche Test- und Linting-Tools verwendet Kevin häufig?	skills.testing_linting	Editorial.Personal
In welchen Test- und Linting-Tools weist Kevin Fachwissen auf?	skills.testing_linting	Editorial.Personal
In welchen Azure-Diensten verfügt Kevin über Fachkenntnisse?	skills.cloud_platforms.azure	Editorial.Personal
"Können Sie die Azure-Dienste auflisten, mit denen Kevin vertraut ist?"	skills.cloud_platforms.azure	Editorial.Personal
Beschreiben Sie Kevins Fachwissen in verschiedenen Azure-Diensten.	skills.cloud_platforms.azure	Editorial.Personal
Welche Azure-Dienste nutzt Kevin häufig?	skills.cloud_platforms.azure	Editorial.Personal
In welchen Azure-Diensten weist Kevin Fachwissen auf?	skills.cloud_platforms.azure	Editorial.Personal
Mit welchen anderen Cloud-Plattformen hat Kevin neben Azure Erfahrung?	skills.cloud_platforms.other	Editorial.Personal
"Können Sie die anderen Cloud-Plattformen auflisten, mit denen Kevin Erfahrung hat?"	skills.cloud_platforms.other	Editorial.Personal
Beschreiben Sie Kevins Erfahrungen mit anderen Cloud-Plattformen neben Azure.	skills.cloud_platforms.other	Editorial.Personal
Welche anderen Cloud-Plattformen nutzt Kevin häufig?	skills.cloud_platforms.other	Editorial.Personal
In welchen anderen Cloud-Plattformen weist Kevin Fachwissen auf?	skills.cloud_platforms.other	Editorial.Personal
Welche Planungs- und Designwerkzeuge beherrscht Kevin?	skills.planning_design	Editorial.Personal
"Können Sie die Planungs- und Designtools auflisten, die Kevin verwendet?"	skills.planning_design	Editorial.Personal
Beschreiben Sie Kevins Kenntnisse in verschiedenen Planungs- und Designtools.	skills.planning_design	Editorial.Personal
Welche Planungs- und Designtools verwendet Kevin häufig?	skills.planning_design	Editorial.Personal
In welchen Planungs- und Designtools weist Kevin Fachwissen auf?	skills.planning_design	Editorial.Personal
Über welche Zertifizierungen verfügt Kevin im Zusammenhang mit Azure?	certifications.azure	Editorial.Personal
Können Sie Kevins Azure-bezogene Zertifizierungen auflisten?	certifications.azure	Editorial.Personal
Beschreiben Sie Kevins Zertifizierungen in Azure.	certifications.azure	Editorial.Personal
Welche Azure-Zertifizierungen hat Kevin erhalten?	certifications.azure	Editorial.Personal
In welchen Azure-Zertifizierungen verfügt Kevin über Fachwissen?	certifications.azure	Editorial.Personal
Welche Zertifizierungen hat Kevin im Bereich Deep Learning abgeschlossen?	certifications.deep_learning	Editorial.Personal
Können Sie Kevins Zertifizierungen im Bereich Deep Learning auflisten?	certifications.deep_learning	Editorial.Personal
Beschreiben Sie Kevins Zertifizierungen im Zusammenhang mit Deep Learning.	certifications.deep_learning	Editorial.Personal
Welche Deep-Learning-Zertifizierungen hat Kevin erhalten?	certifications.deep_learning	Editorial.Personal
In welchen Deep-Learning-Zertifizierungen verfügt Kevin über Fachwissen?	certifications.deep_learning	Editorial.Personal
Welches Programm hat Kevin am MIT abgeschlossen?	certifications.mit	Editorial.Personal
"Können Sie das Programm auflisten, das Kevin am MIT abgeschlossen hat?"	certifications.mit	Editorial.Personal
Beschreiben Sie Kevins Abschluss des New Space Economy-Programms am MIT.	certifications.mit	Editorial.Personal
An welchem Programm nahm Kevin am MIT teil?	certifications.mit	Editorial.Personal
In welchem Programm am MIT ist Kevin anerkannt?	certifications.mit	Editorial.Personal
Wo erlangte Kevin ein tieferes Verständnis des Raumfahrtsektors?	education.mit	Editorial.Personal
Können Sie Kevins Ausbildung im Raumfahrtsektor näher erläutern?	education.mit	Editorial.Personal
Beschreiben Sie Kevins fortgeschrittenes Verständnis des Raumfahrtsektors vom MIT.	education.mit	Editorial.Personal
Was hat Kevin am MIT im Zusammenhang mit dem Raumfahrtsektor studiert?	education.mit	Editorial.Personal
In welchem Programm am MIT hat Kevin Fachwissen im Raumfahrtsektor erworben?	education.mit	Editorial.Personal
An welcher Hochschule hat Kevin seinen Abschluss gemacht?	education.tci_college	Editorial.Personal
"Können Sie das College auflisten, an dem Kevin seinen Abschluss gemacht hat?"	education.tci_college	Editorial.Personal
Welche Erfolge hat Kevin beim Wolves Summit 2021 erzielt?	awards.recognition	Editorial.Personal
Welche Auszeichnungen erhielt Kevin für seine Beiträge zur Devoteam AI Academy?	awards.recognition	Editorial.Personal
Welche Anerkennungen hat Kevin erhalten?	awards.recognition	Editorial.Personal
Welche bemerkenswerten Wettbewerbe oder Auszeichnungen hat Kevin gewonnen?	awards.recognition	Editorial.Personal
Welche Beteiligung hat Kevin an der Förderung des KI-Bewusstseins?	interviews.participation	Editorial.Personal
Wo hat Kevin als Redner teilgenommen?	interviews.participation	Editorial.Personal
Zu welchen bemerkenswerten Ereignissen im Bereich der KI-Ausbildung hat Kevin beigetragen?	interviews.participation	Editorial.Personal
Wie wurde Kevin auf dem Gebiet der künstlichen Intelligenz anerkannt?	interviews.participation	Editorial.Personal