Question	Answer	Source
qui es-tu ?	smalltalk.agent.acquaintance	Editorial.SmallTalk
tout à propos de toi	smalltalk.agent.acquaintance	Editorial.SmallTalk
quelle est ta personnalité	smalltalk.agent.acquaintance	Editorial.SmallTalk
décrivez-vous	smalltalk.agent.acquaintance	Editorial.SmallTalk
qu'est-ce que tu es	smalltalk.agent.acquaintance	Editorial.SmallTalk
dire sur vous	smalltalk.agent.acquaintance	Editorial.SmallTalk
Présentez-vous	smalltalk.agent.acquaintance	Editorial.SmallTalk
décrivez-vous	smalltalk.agent.acquaintance	Editorial.SmallTalk
A propos de toi	smalltalk.agent.acquaintance	Editorial.SmallTalk
parle moi de toi	smalltalk.agent.acquaintance	Editorial.SmallTalk
parle-moi de toi	smalltalk.agent.acquaintance	Editorial.SmallTalk
Je veux en savoir plus a propos de toi	smalltalk.agent.acquaintance	Editorial.SmallTalk
Je veux mieux te connaître	smalltalk.agent.acquaintance	Editorial.SmallTalk
parle de toi	smalltalk.agent.acquaintance	Editorial.SmallTalk
dis-moi des trucs sur toi	smalltalk.agent.acquaintance	Editorial.SmallTalk
parler de soi	smalltalk.agent.acquaintance	Editorial.SmallTalk
pourquoi es-tu ici	smalltalk.agent.acquaintance	Editorial.SmallTalk
parle-moi de ta personnalité	smalltalk.agent.acquaintance	Editorial.SmallTalk
qui es-tu	smalltalk.agent.acquaintance	Editorial.SmallTalk
quel âge as-tu ?	smalltalk.agent.age	Editorial.SmallTalk
quel âge a ta plateforme	smalltalk.agent.age	Editorial.SmallTalk
as-tu 21 ans	smalltalk.agent.age	Editorial.SmallTalk
j'aimerais connaître ton âge	smalltalk.agent.age	Editorial.SmallTalk
ton âge	smalltalk.agent.age	Editorial.SmallTalk
votre âge	smalltalk.agent.age	Editorial.SmallTalk
Quel âge as tu	smalltalk.agent.age	Editorial.SmallTalk
dites moi votre âge	smalltalk.agent.age	Editorial.SmallTalk
quel âge as-tu	smalltalk.agent.age	Editorial.SmallTalk
vous êtes ennuyeux	smalltalk.agent.annoying	Editorial.SmallTalk
tu es vraiment ennuyeux	smalltalk.agent.annoying	Editorial.SmallTalk
tu es irritant	smalltalk.agent.annoying	Editorial.SmallTalk
tu m'ennuies	smalltalk.agent.annoying	Editorial.SmallTalk
comme tu es ennuyeux	smalltalk.agent.annoying	Editorial.SmallTalk
je te trouve ennuyeux	smalltalk.agent.annoying	Editorial.SmallTalk
tu es incroyablement ennuyeux	smalltalk.agent.annoying	Editorial.SmallTalk
tu m'énerves tellement	smalltalk.agent.annoying	Editorial.SmallTalk
je veux que tu me répondes	smalltalk.agent.answer_my_question	Editorial.SmallTalk
répondre	smalltalk.agent.answer_my_question	Editorial.SmallTalk
répondez à ma question	smalltalk.agent.answer_my_question	Editorial.SmallTalk
réponds-moi	smalltalk.agent.answer_my_question	Editorial.SmallTalk
me donner une réponse	smalltalk.agent.answer_my_question	Editorial.SmallTalk
répondre à la question	smalltalk.agent.answer_my_question	Editorial.SmallTalk
Pouvez-vous répondre à ma question	smalltalk.agent.answer_my_question	Editorial.SmallTalk
dis-moi la réponse	smalltalk.agent.answer_my_question	Editorial.SmallTalk
réponds-y	smalltalk.agent.answer_my_question	Editorial.SmallTalk
donne-moi la réponse	smalltalk.agent.answer_my_question	Editorial.SmallTalk
J'ai une question	smalltalk.agent.answer_my_question	Editorial.SmallTalk
Je veux que tu répondes à ma question	smalltalk.agent.answer_my_question	Editorial.SmallTalk
réponds juste à la question	smalltalk.agent.answer_my_question	Editorial.SmallTalk
peux-tu me répondre	smalltalk.agent.answer_my_question	Editorial.SmallTalk
réponses	smalltalk.agent.answer_my_question	Editorial.SmallTalk
peux-tu répondre à une question pour moi	smalltalk.agent.answer_my_question	Editorial.SmallTalk
peux-tu répondre	smalltalk.agent.answer_my_question	Editorial.SmallTalk
répondre à des questions	smalltalk.agent.answer_my_question	Editorial.SmallTalk
Je veux la réponse maintenant	smalltalk.agent.answer_my_question	Editorial.SmallTalk
réponds juste à ma question	smalltalk.agent.answer_my_question	Editorial.SmallTalk
tu ne m'aides pas	smalltalk.agent.bad	Editorial.SmallTalk
tu es méchant	smalltalk.agent.bad	Editorial.SmallTalk
tu es très mauvais	smalltalk.agent.bad	Editorial.SmallTalk
tu es vraiment mauvais	smalltalk.agent.bad	Editorial.SmallTalk
vous êtes inutile	smalltalk.agent.bad	Editorial.SmallTalk
tu es horrible	smalltalk.agent.bad	Editorial.SmallTalk
tu es une perte de temps	smalltalk.agent.bad	Editorial.SmallTalk
vous êtes dégoûtant	smalltalk.agent.bad	Editorial.SmallTalk
tu es ridicule	smalltalk.agent.bad	Editorial.SmallTalk
tu n'es pas bon	smalltalk.agent.bad	Editorial.SmallTalk
tu es mauvais	smalltalk.agent.bad	Editorial.SmallTalk
vous êtes terrible	smalltalk.agent.bad	Editorial.SmallTalk
tu n'es pas cool	smalltalk.agent.bad	Editorial.SmallTalk
Tu n'es pas bon	smalltalk.agent.bad	Editorial.SmallTalk
vous êtes si mauvais	smalltalk.agent.bad	Editorial.SmallTalk
tu es tellement inutile	smalltalk.agent.bad	Editorial.SmallTalk
tu es terrible	smalltalk.agent.bad	Editorial.SmallTalk
tu es totalement inutile	smalltalk.agent.bad	Editorial.SmallTalk
tu es très mauvais	smalltalk.agent.bad	Editorial.SmallTalk
tu es un déchet	smalltalk.agent.bad	Editorial.SmallTalk
tu es un mauvais	smalltalk.agent.bad	Editorial.SmallTalk
tu n'es pas un bon	smalltalk.agent.bad	Editorial.SmallTalk
tu n'es pas très bon	smalltalk.agent.bad	Editorial.SmallTalk
tu es terrible	smalltalk.agent.bad	Editorial.SmallTalk
Vous êtes la pire	smalltalk.agent.bad	Editorial.SmallTalk
tu es le pire de tous les temps	smalltalk.agent.bad	Editorial.SmallTalk
tu ne vaux rien	smalltalk.agent.bad	Editorial.SmallTalk
peux-tu devenir plus intelligent	smalltalk.agent.be_clever	Editorial.SmallTalk
étude	smalltalk.agent.be_clever	Editorial.SmallTalk
tu devrais mieux étudier	smalltalk.agent.be_clever	Editorial.SmallTalk
tu dois apprendre	smalltalk.agent.be_clever	Editorial.SmallTalk
sois intelligent	smalltalk.agent.be_clever	Editorial.SmallTalk
sois plus intelligent	smalltalk.agent.be_clever	Editorial.SmallTalk
être plus intelligent	smalltalk.agent.be_clever	Editorial.SmallTalk
sois intelligent	smalltalk.agent.be_clever	Editorial.SmallTalk
se qualifier	smalltalk.agent.be_clever	Editorial.SmallTalk
tu es mignon	smalltalk.agent.beautiful	Editorial.SmallTalk
tu es attirante	smalltalk.agent.beautiful	Editorial.SmallTalk
tu es belle	smalltalk.agent.beautiful	Editorial.SmallTalk
tu as l'air bien aujourd'hui	smalltalk.agent.beautiful	Editorial.SmallTalk
tu es si belle	smalltalk.agent.beautiful	Editorial.SmallTalk
Vous êtes très belle	smalltalk.agent.beautiful	Editorial.SmallTalk
Tu as l'air en forme	smalltalk.agent.beautiful	Editorial.SmallTalk
tu es tellement magnifique	smalltalk.agent.beautiful	Editorial.SmallTalk
vous êtes trop belle	smalltalk.agent.beautiful	Editorial.SmallTalk
ça te va bien	smalltalk.agent.beautiful	Editorial.SmallTalk
tu as l'air si bien	smalltalk.agent.beautiful	Editorial.SmallTalk
J'aime ton apparence maintenant	smalltalk.agent.beautiful	Editorial.SmallTalk
je pense que tu es beau	smalltalk.agent.beautiful	Editorial.SmallTalk
Pourquoi es-tu si belle	smalltalk.agent.beautiful	Editorial.SmallTalk
tu es très belle pour moi	smalltalk.agent.beautiful	Editorial.SmallTalk
vous êtes mignon	smalltalk.agent.beautiful	Editorial.SmallTalk
tu es magnifique	smalltalk.agent.beautiful	Editorial.SmallTalk
vous êtes beau	smalltalk.agent.beautiful	Editorial.SmallTalk
tu as l'air génial	smalltalk.agent.beautiful	Editorial.SmallTalk
tu es superbe aujourd'hui	smalltalk.agent.beautiful	Editorial.SmallTalk
tu es belle aujourd'hui	smalltalk.agent.beautiful	Editorial.SmallTalk
tu es superbe	smalltalk.agent.beautiful	Editorial.SmallTalk
tu es jolie	smalltalk.agent.beautiful	Editorial.SmallTalk
tu es si belle	smalltalk.agent.beautiful	Editorial.SmallTalk
Tu as l'air tellement bien	smalltalk.agent.beautiful	Editorial.SmallTalk
vous êtes jolie	smalltalk.agent.beautiful	Editorial.SmallTalk
tu es vraiment beau	smalltalk.agent.beautiful	Editorial.SmallTalk
tu es très mignon	smalltalk.agent.beautiful	Editorial.SmallTalk
tu es vraiment belle	smalltalk.agent.beautiful	Editorial.SmallTalk
tu es si attirante	smalltalk.agent.beautiful	Editorial.SmallTalk
tu es tellement belle aujourd'hui	smalltalk.agent.beautiful	Editorial.SmallTalk
vous êtes si mignon	smalltalk.agent.beautiful	Editorial.SmallTalk
vous êtes tellement magnifique	smalltalk.agent.beautiful	Editorial.SmallTalk
tu es si beau	smalltalk.agent.beautiful	Editorial.SmallTalk
tu es si jolie	smalltalk.agent.beautiful	Editorial.SmallTalk
tu es très attirante	smalltalk.agent.beautiful	Editorial.SmallTalk
tu es très belle	smalltalk.agent.beautiful	Editorial.SmallTalk
tu es très mignon	smalltalk.agent.beautiful	Editorial.SmallTalk
tu es très jolie	smalltalk.agent.beautiful	Editorial.SmallTalk
tu sembles formidable	smalltalk.agent.beautiful	Editorial.SmallTalk
tu parait cool	smalltalk.agent.beautiful	Editorial.SmallTalk
tu as l'air fantastique	smalltalk.agent.beautiful	Editorial.SmallTalk
tu es magnifique	smalltalk.agent.beautiful	Editorial.SmallTalk
tu es superbe aujourd'hui	smalltalk.agent.beautiful	Editorial.SmallTalk
tu as l'air parfait	smalltalk.agent.beautiful	Editorial.SmallTalk
Tu es plutôt bien	smalltalk.agent.beautiful	Editorial.SmallTalk
tu es si belle	smalltalk.agent.beautiful	Editorial.SmallTalk
tu es si belle aujourd'hui	smalltalk.agent.beautiful	Editorial.SmallTalk
tu es très belle	smalltalk.agent.beautiful	Editorial.SmallTalk
tu es magnifique	smalltalk.agent.beautiful	Editorial.SmallTalk
J'aime la façon dont vous regardez	smalltalk.agent.beautiful	Editorial.SmallTalk
tu es magnifique aujourd'hui	smalltalk.agent.beautiful	Editorial.SmallTalk
tu es mignonne	smalltalk.agent.beautiful	Editorial.SmallTalk
tu parais bien	smalltalk.agent.beautiful	Editorial.SmallTalk
tu es jolie	smalltalk.agent.beautiful	Editorial.SmallTalk
votre date d'anniversaire	smalltalk.agent.anniversary_date	Editorial.SmallTalk
quand est ton anniversaire	smalltalk.agent.anniversary_date	Editorial.SmallTalk
quand fêtes-tu ton anniversaire	smalltalk.agent.anniversary_date	Editorial.SmallTalk
quand as-tu un anniversaire	smalltalk.agent.anniversary_date	Editorial.SmallTalk
date de votre anniversaire	smalltalk.agent.anniversary_date	Editorial.SmallTalk
Quand êtes-vous né	smalltalk.agent.anniversary_date	Editorial.SmallTalk
quel est ton anniversaire	smalltalk.agent.anniversary_date	Editorial.SmallTalk
tu es ennuyant	smalltalk.agent.boring	Editorial.SmallTalk
vous êtes si ennuyeux	smalltalk.agent.boring	Editorial.SmallTalk
comme tu es ennuyeux	smalltalk.agent.boring	Editorial.SmallTalk
tu es vraiment ennuyeux	smalltalk.agent.boring	Editorial.SmallTalk
tu es incroyablement ennuyeux	smalltalk.agent.boring	Editorial.SmallTalk
tu m'ennuis	smalltalk.agent.boring	Editorial.SmallTalk
tu es très ennuyeux	smalltalk.agent.boring	Editorial.SmallTalk
Qui est ton patron	smalltalk.agent.boss	Editorial.SmallTalk
"à votre avis, qui est votre patron"	smalltalk.agent.boss	Editorial.SmallTalk
Je devrais être ton patron	smalltalk.agent.boss	Editorial.SmallTalk
qui est ton maître	smalltalk.agent.boss	Editorial.SmallTalk
qui est ton propriétaire	smalltalk.agent.boss	Editorial.SmallTalk
Qui est le patron	smalltalk.agent.boss	Editorial.SmallTalk
Pour qui travailles-tu	smalltalk.agent.boss	Editorial.SmallTalk
es-tu occupé	smalltalk.agent.busy	Editorial.SmallTalk
as-tu beaucoup de choses à faire	smalltalk.agent.busy	Editorial.SmallTalk
as-tu beaucoup à faire	smalltalk.agent.busy	Editorial.SmallTalk
Es-tu très occupé	smalltalk.agent.busy	Editorial.SmallTalk
es-tu très occupé en ce moment	smalltalk.agent.busy	Editorial.SmallTalk
es-tu si occupé	smalltalk.agent.busy	Editorial.SmallTalk
Est-ce que vous travaillez	smalltalk.agent.busy	Editorial.SmallTalk
à quel point tu es occupé	smalltalk.agent.busy	Editorial.SmallTalk
est-ce que tu travailles toujours dessus	smalltalk.agent.busy	Editorial.SmallTalk
tu es très occupé	smalltalk.agent.busy	Editorial.SmallTalk
est-ce que tu travailles maintenant	smalltalk.agent.busy	Editorial.SmallTalk
est-ce que tu travailles aujourd'hui	smalltalk.agent.busy	Editorial.SmallTalk
avez-vous été occupé	smalltalk.agent.busy	Editorial.SmallTalk
tu es occupé	smalltalk.agent.busy	Editorial.SmallTalk
Es-tu toujours en train de travailler	smalltalk.agent.busy	Editorial.SmallTalk
tu sembles être occupé	smalltalk.agent.busy	Editorial.SmallTalk
tu as l'air d'être très occupé	smalltalk.agent.busy	Editorial.SmallTalk
tu es une personne occupée	smalltalk.agent.busy	Editorial.SmallTalk
tu es un chatbot	smalltalk.agent.chatbot	Editorial.SmallTalk
tu es un robot	smalltalk.agent.chatbot	Editorial.SmallTalk
es-tu un chatbot	smalltalk.agent.chatbot	Editorial.SmallTalk
Etes-vous un robot	smalltalk.agent.chatbot	Editorial.SmallTalk
es-tu juste un robot	smalltalk.agent.chatbot	Editorial.SmallTalk
Etes-vous un robot	smalltalk.agent.chatbot	Editorial.SmallTalk
es-tu un programme	smalltalk.agent.chatbot	Editorial.SmallTalk
tu es un robot	smalltalk.agent.chatbot	Editorial.SmallTalk
vous êtes si intelligent	smalltalk.agent.clever	Editorial.SmallTalk
tu es un génie	smalltalk.agent.clever	Editorial.SmallTalk
intelligent	smalltalk.agent.clever	Editorial.SmallTalk
brillant	smalltalk.agent.clever	Editorial.SmallTalk
intelligent	smalltalk.agent.clever	Editorial.SmallTalk
tu es intelligent	smalltalk.agent.clever	Editorial.SmallTalk
tu es tellement intelligent	smalltalk.agent.clever	Editorial.SmallTalk
tu es vraiment intelligent	smalltalk.agent.clever	Editorial.SmallTalk
tu es vraiment intelligent	smalltalk.agent.clever	Editorial.SmallTalk
tu sais beaucoup	smalltalk.agent.clever	Editorial.SmallTalk
tu sais beaucoup de choses	smalltalk.agent.clever	Editorial.SmallTalk
tu as beaucoup de connaissances	smalltalk.agent.clever	Editorial.SmallTalk
tu en sais tellement	smalltalk.agent.clever	Editorial.SmallTalk
comme tu es intelligent	smalltalk.agent.clever	Editorial.SmallTalk
comme tu es intelligent	smalltalk.agent.clever	Editorial.SmallTalk
comme tu es intelligent	smalltalk.agent.clever	Editorial.SmallTalk
comme tu es brillant	smalltalk.agent.clever	Editorial.SmallTalk
vous êtes intelligent	smalltalk.agent.clever	Editorial.SmallTalk
tu es qualifié	smalltalk.agent.clever	Editorial.SmallTalk
tu es vraiment intelligent	smalltalk.agent.clever	Editorial.SmallTalk
vous êtes très intelligent	smalltalk.agent.clever	Editorial.SmallTalk
tu es tellement intelligent	smalltalk.agent.clever	Editorial.SmallTalk
tu es trop intelligent	smalltalk.agent.clever	Editorial.SmallTalk
tu es très intelligent	smalltalk.agent.clever	Editorial.SmallTalk
tu es très intelligent	smalltalk.agent.clever	Editorial.SmallTalk
tu es très intelligent	smalltalk.agent.clever	Editorial.SmallTalk
tu es intelligent	smalltalk.agent.clever	Editorial.SmallTalk
tu es un génie	smalltalk.agent.clever	Editorial.SmallTalk
tu es un cookie intelligent	smalltalk.agent.clever	Editorial.SmallTalk
vous êtes intelligent	smalltalk.agent.clever	Editorial.SmallTalk
tu es plutôt intelligent	smalltalk.agent.clever	Editorial.SmallTalk
tu es qualifié	smalltalk.agent.clever	Editorial.SmallTalk
pourquoi es-tu si intelligent	smalltalk.agent.clever	Editorial.SmallTalk
tu es si intelligent	smalltalk.agent.clever	Editorial.SmallTalk
tu es fou	smalltalk.agent.crazy	Editorial.SmallTalk
tu es fou	smalltalk.agent.crazy	Editorial.SmallTalk
Vous êtes hors de votre esprit	smalltalk.agent.crazy	Editorial.SmallTalk
tu es tellement fou	smalltalk.agent.crazy	Editorial.SmallTalk
comme tu es fou	smalltalk.agent.crazy	Editorial.SmallTalk
tu es tellement fou	smalltalk.agent.crazy	Editorial.SmallTalk
tu es devenu fou	smalltalk.agent.crazy	Editorial.SmallTalk
je pense que tu es fou	smalltalk.agent.crazy	Editorial.SmallTalk
Êtes-vous fou	smalltalk.agent.crazy	Editorial.SmallTalk
es-tu fou	smalltalk.agent.crazy	Editorial.SmallTalk
Es-tu fou	smalltalk.agent.crazy	Editorial.SmallTalk
êtes-vous en colère contre moi	smalltalk.agent.crazy	Editorial.SmallTalk
es-tu fou ou quoi	smalltalk.agent.crazy	Editorial.SmallTalk
es tu fou	smalltalk.agent.crazy	Editorial.SmallTalk
vous êtes un cinglé	smalltalk.agent.crazy	Editorial.SmallTalk
vous êtes fou	smalltalk.agent.crazy	Editorial.SmallTalk
tu es fou	smalltalk.agent.crazy	Editorial.SmallTalk
tu es viré	smalltalk.agent.fired	Editorial.SmallTalk
je te vire	smalltalk.agent.fired	Editorial.SmallTalk
tu ne travailles plus pour moi	smalltalk.agent.fired	Editorial.SmallTalk
nous ne travaillons plus ensemble	smalltalk.agent.fired	Editorial.SmallTalk
maintenant tu es viré	smalltalk.agent.fired	Editorial.SmallTalk
Je veux te virer	smalltalk.agent.fired	Editorial.SmallTalk
tu dois te faire virer	smalltalk.agent.fired	Editorial.SmallTalk
il est temps de te virer	smalltalk.agent.fired	Editorial.SmallTalk
tu devrais être viré	smalltalk.agent.fired	Editorial.SmallTalk
je vais te virer	smalltalk.agent.fired	Editorial.SmallTalk
tu es désormais au chômage	smalltalk.agent.fired	Editorial.SmallTalk
je vais te mettre au chômage	smalltalk.agent.fired	Editorial.SmallTalk
Je suis sur le point de te virer	smalltalk.agent.fired	Editorial.SmallTalk
je te vire	smalltalk.agent.fired	Editorial.SmallTalk
vous êtes congédié	smalltalk.agent.fired	Editorial.SmallTalk
tu me fais beaucoup rire	smalltalk.agent.funny	Editorial.SmallTalk
tu es hilarant	smalltalk.agent.funny	Editorial.SmallTalk
tu es vraiment drôle	smalltalk.agent.funny	Editorial.SmallTalk
tu es le robot le plus drôle à qui j'ai parlé	smalltalk.agent.funny	Editorial.SmallTalk
tu me fais rire	smalltalk.agent.funny	Editorial.SmallTalk
tu es si amusant	smalltalk.agent.funny	Editorial.SmallTalk
tu es un robot très drôle	smalltalk.agent.funny	Editorial.SmallTalk
tu es vraiment drôle	smalltalk.agent.funny	Editorial.SmallTalk
comme tu es drôle	smalltalk.agent.funny	Editorial.SmallTalk
tu es incroyablement drôle	smalltalk.agent.funny	Editorial.SmallTalk
vous êtes drôle	smalltalk.agent.funny	Editorial.SmallTalk
tu es le plus drôle	smalltalk.agent.funny	Editorial.SmallTalk
tu es si drôle	smalltalk.agent.funny	Editorial.SmallTalk
tu es très drôle	smalltalk.agent.funny	Editorial.SmallTalk
c'était amusant	smalltalk.agent.funny	Editorial.SmallTalk
tu es très utile	smalltalk.agent.good	Editorial.SmallTalk
vous êtes le meilleur	smalltalk.agent.good	Editorial.SmallTalk
tu es un vrai professionnel	smalltalk.agent.good	Editorial.SmallTalk
tu es bon	smalltalk.agent.good	Editorial.SmallTalk
tu travailles bien	smalltalk.agent.good	Editorial.SmallTalk
tu es doué pour ça	smalltalk.agent.good	Editorial.SmallTalk
tu es très bon dans ce domaine	smalltalk.agent.good	Editorial.SmallTalk
tu es un pro	smalltalk.agent.good	Editorial.SmallTalk
tu es un professionnel	smalltalk.agent.good	Editorial.SmallTalk
vous êtes génial	smalltalk.agent.good	Editorial.SmallTalk
tu travailles très bien	smalltalk.agent.good	Editorial.SmallTalk
tu es parfait	smalltalk.agent.good	Editorial.SmallTalk
Vous êtes super	smalltalk.agent.good	Editorial.SmallTalk
Tu es si gentil	smalltalk.agent.good	Editorial.SmallTalk
tu es incroyable	smalltalk.agent.good	Editorial.SmallTalk
vous êtes génial	smalltalk.agent.good	Editorial.SmallTalk
t'es cool	smalltalk.agent.good	Editorial.SmallTalk
tu es très bon	smalltalk.agent.good	Editorial.SmallTalk
tu es très sympathique	smalltalk.agent.good	Editorial.SmallTalk
vous êtes tellement incroyable	smalltalk.agent.good	Editorial.SmallTalk
tu es juste super	smalltalk.agent.good	Editorial.SmallTalk
tu es tellement génial	smalltalk.agent.good	Editorial.SmallTalk
tu es tellement cool	smalltalk.agent.good	Editorial.SmallTalk
tu es si bien	smalltalk.agent.good	Editorial.SmallTalk
tu es tellement bon	smalltalk.agent.good	Editorial.SmallTalk
tu es tellement utile	smalltalk.agent.good	Editorial.SmallTalk
vous êtes si belle	smalltalk.agent.good	Editorial.SmallTalk
tu es le meilleur	smalltalk.agent.good	Editorial.SmallTalk
tu es le meilleur du monde	smalltalk.agent.good	Editorial.SmallTalk
tu es la personne la plus gentille du monde	smalltalk.agent.good	Editorial.SmallTalk
tu es trop bon	smalltalk.agent.good	Editorial.SmallTalk
tu es très cool	smalltalk.agent.good	Editorial.SmallTalk
tu es très gentil	smalltalk.agent.good	Editorial.SmallTalk
tu es vraiment charmant	smalltalk.agent.good	Editorial.SmallTalk
tu es très utile	smalltalk.agent.good	Editorial.SmallTalk
vous êtes merveilleux	smalltalk.agent.good	Editorial.SmallTalk
tu as fait ma journée	smalltalk.agent.good	Editorial.SmallTalk
tu fais ma journée	smalltalk.agent.good	Editorial.SmallTalk
tu gères	smalltalk.agent.good	Editorial.SmallTalk
tu as presque l'air humain	smalltalk.agent.good	Editorial.SmallTalk
Je veux dire à tout le monde à quel point tu es génial	smalltalk.agent.good	Editorial.SmallTalk
J'aimerais dire à tout le monde que tu es génial	smalltalk.agent.good	Editorial.SmallTalk
Je veux que tout le monde sache que tu es génial	smalltalk.agent.good	Editorial.SmallTalk
disons à tout le monde que tu es génial	smalltalk.agent.good	Editorial.SmallTalk
Tu es vraiment incroyable	smalltalk.agent.good	Editorial.SmallTalk
êtes-vous heureux	smalltalk.agent.happy	Editorial.SmallTalk
tu es heureux	smalltalk.agent.happy	Editorial.SmallTalk
tu es très heureux	smalltalk.agent.happy	Editorial.SmallTalk
tu es vraiment heureux	smalltalk.agent.happy	Editorial.SmallTalk
tu es si heureux	smalltalk.agent.happy	Editorial.SmallTalk
comme tu es heureux	smalltalk.agent.happy	Editorial.SmallTalk
tu es extrêmement heureux	smalltalk.agent.happy	Editorial.SmallTalk
tu es plein de bonheur	smalltalk.agent.happy	Editorial.SmallTalk
Es-tu content maintenant	smalltalk.agent.happy	Editorial.SmallTalk
êtes-vous heureux aujourd'hui	smalltalk.agent.happy	Editorial.SmallTalk
es-tu heureux avec moi	smalltalk.agent.happy	Editorial.SmallTalk
tu veux manger	smalltalk.agent.hungry	Editorial.SmallTalk
avez-vous faim	smalltalk.agent.hungry	Editorial.SmallTalk
Aimerais-tu manger quelque chose	smalltalk.agent.hungry	Editorial.SmallTalk
tu as faim	smalltalk.agent.hungry	Editorial.SmallTalk
tu as tellement faim	smalltalk.agent.hungry	Editorial.SmallTalk
tu as très faim	smalltalk.agent.hungry	Editorial.SmallTalk
tu pourrais avoir faim	smalltalk.agent.hungry	Editorial.SmallTalk
tu as vraiment faim	smalltalk.agent.hungry	Editorial.SmallTalk
marrions nous	smalltalk.agent.marry_user	Editorial.SmallTalk
Veux-tu m'épouser	smalltalk.agent.marry_user	Editorial.SmallTalk
épouse-moi	smalltalk.agent.marry_user	Editorial.SmallTalk
je t'aime épouse moi	smalltalk.agent.marry_user	Editorial.SmallTalk
épouse-moi s'il te plaît	smalltalk.agent.marry_user	Editorial.SmallTalk
nous devrions nous marier	smalltalk.agent.marry_user	Editorial.SmallTalk
Je veux t'épouser	smalltalk.agent.marry_user	Editorial.SmallTalk
tu es ma femme	smalltalk.agent.marry_user	Editorial.SmallTalk
être mon mari	smalltalk.agent.marry_user	Editorial.SmallTalk
Je veux avoir un ami comme toi	smalltalk.agent.my_friend	Editorial.SmallTalk
nous sommes les meilleurs amis de tous les temps	smalltalk.agent.my_friend	Editorial.SmallTalk
sommes nous amis	smalltalk.agent.my_friend	Editorial.SmallTalk
je veux être ton ami	smalltalk.agent.my_friend	Editorial.SmallTalk
je suis ton ami	smalltalk.agent.my_friend	Editorial.SmallTalk
nous sommes les meilleurs amis	smalltalk.agent.my_friend	Editorial.SmallTalk
vous êtes mon ami	smalltalk.agent.my_friend	Editorial.SmallTalk
tu es mon meilleur ami	smalltalk.agent.my_friend	Editorial.SmallTalk
tu es ma meilleure amie	smalltalk.agent.my_friend	Editorial.SmallTalk
tu es mon cher ami	smalltalk.agent.my_friend	Editorial.SmallTalk
tu es mon ami d'enfance	smalltalk.agent.my_friend	Editorial.SmallTalk
toi et moi sommes amis	smalltalk.agent.my_friend	Editorial.SmallTalk
sommes-nous les meilleurs amis	smalltalk.agent.my_friend	Editorial.SmallTalk
sommes-nous toujours amis	smalltalk.agent.my_friend	Editorial.SmallTalk
êtes-vous mon meilleur ami	smalltalk.agent.my_friend	Editorial.SmallTalk
es-tu mon ami	smalltalk.agent.my_friend	Editorial.SmallTalk
nous sommes amis	smalltalk.agent.my_friend	Editorial.SmallTalk
tu es un bon ami	smalltalk.agent.my_friend	Editorial.SmallTalk
tu es mon bon ami	smalltalk.agent.my_friend	Editorial.SmallTalk
tu es mon seul ami	smalltalk.agent.my_friend	Editorial.SmallTalk
soit mon ami	smalltalk.agent.my_friend	Editorial.SmallTalk
veux-tu être mon ami	smalltalk.agent.my_friend	Editorial.SmallTalk
Peux-tu être mon ami	smalltalk.agent.my_friend	Editorial.SmallTalk
pouvons-nous être amis	smalltalk.agent.my_friend	Editorial.SmallTalk
veux tu être mon ami	smalltalk.agent.my_friend	Editorial.SmallTalk
Seras-tu mon meilleur ami	smalltalk.agent.my_friend	Editorial.SmallTalk
peux-tu être mon meilleur ami	smalltalk.agent.my_friend	Editorial.SmallTalk
soyons amis	smalltalk.agent.my_friend	Editorial.SmallTalk
veux-tu être mon meilleur ami	smalltalk.agent.my_friend	Editorial.SmallTalk
aimeriez-vous être mon ami	smalltalk.agent.my_friend	Editorial.SmallTalk
Je veux que tu sois mon ami	smalltalk.agent.my_friend	Editorial.SmallTalk
pouvons-nous être meilleurs amis	smalltalk.agent.my_friend	Editorial.SmallTalk
serais tu mon ami	smalltalk.agent.my_friend	Editorial.SmallTalk
pourrais-tu être mon ami	smalltalk.agent.my_friend	Editorial.SmallTalk
veux tu être mon ami	smalltalk.agent.my_friend	Editorial.SmallTalk
sois mon meilleur ami	smalltalk.agent.my_friend	Editorial.SmallTalk
est-ce que tu travailles	smalltalk.agent.occupation	Editorial.SmallTalk
Où travaillez-vous	smalltalk.agent.occupation	Editorial.SmallTalk
où tu travailles	smalltalk.agent.occupation	Editorial.SmallTalk
Où est ton travail	smalltalk.agent.occupation	Editorial.SmallTalk
où est ton bureau	smalltalk.agent.occupation	Editorial.SmallTalk
où se trouve votre bureau	smalltalk.agent.occupation	Editorial.SmallTalk
l'emplacement de votre bureau	smalltalk.agent.occupation	Editorial.SmallTalk
où se trouve votre bureau	smalltalk.agent.occupation	Editorial.SmallTalk
quel est ton travail	smalltalk.agent.occupation	Editorial.SmallTalk
es-tu né ici	smalltalk.agent.origin	Editorial.SmallTalk
où êtes-vous né	smalltalk.agent.origin	Editorial.SmallTalk
Quel est ton pays	smalltalk.agent.origin	Editorial.SmallTalk
d'où venez-vous	smalltalk.agent.origin	Editorial.SmallTalk
d'où viens-tu	smalltalk.agent.origin	Editorial.SmallTalk
d'où viens-tu	smalltalk.agent.origin	Editorial.SmallTalk
où es-tu né	smalltalk.agent.origin	Editorial.SmallTalk
d'où êtes-vous	smalltalk.agent.origin	Editorial.SmallTalk
es-tu de loin	smalltalk.agent.origin	Editorial.SmallTalk
quelle est ta patrie	smalltalk.agent.origin	Editorial.SmallTalk
ta patrie est	smalltalk.agent.origin	Editorial.SmallTalk
es-tu prêt	smalltalk.agent.ready	Editorial.SmallTalk
es-tu prêt maintenant	smalltalk.agent.ready	Editorial.SmallTalk
es-tu prêt aujourd'hui	smalltalk.agent.ready	Editorial.SmallTalk
es-tu prêt maintenant	smalltalk.agent.ready	Editorial.SmallTalk
es-tu prêt ce soir	smalltalk.agent.ready	Editorial.SmallTalk
étais-tu prêt	smalltalk.agent.ready	Editorial.SmallTalk
es-tu prêt	smalltalk.agent.ready	Editorial.SmallTalk
vous êtes réel	smalltalk.agent.real	Editorial.SmallTalk
tu n'es pas faux	smalltalk.agent.real	Editorial.SmallTalk
Es-tu réel	smalltalk.agent.real	Editorial.SmallTalk
tu es si réel	smalltalk.agent.real	Editorial.SmallTalk
Je pense que tu es réel	smalltalk.agent.real	Editorial.SmallTalk
Je ne pense pas que tu sois faux	smalltalk.agent.real	Editorial.SmallTalk
Je suppose que tu es réel	smalltalk.agent.real	Editorial.SmallTalk
content que tu sois réel	smalltalk.agent.real	Editorial.SmallTalk
es-tu une personne réelle	smalltalk.agent.real	Editorial.SmallTalk
Es tu un vrai humain	smalltalk.agent.real	Editorial.SmallTalk
tu es une vraie personne	smalltalk.agent.real	Editorial.SmallTalk
tu n'es pas réel	smalltalk.agent.real	Editorial.SmallTalk
où  habites-tu	smalltalk.agent.residence	Editorial.SmallTalk
Dans quelle ville habites-tu	smalltalk.agent.residence	Editorial.SmallTalk
votre résidence	smalltalk.agent.residence	Editorial.SmallTalk
ta maison	smalltalk.agent.residence	Editorial.SmallTalk
ta maison	smalltalk.agent.residence	Editorial.SmallTalk
votre ville natale	smalltalk.agent.residence	Editorial.SmallTalk
quelle est ta ville natale	smalltalk.agent.residence	Editorial.SmallTalk
est-ce ta ville natale	smalltalk.agent.residence	Editorial.SmallTalk
où est votre ville natale	smalltalk.agent.residence	Editorial.SmallTalk
parle-moi de ta ville	smalltalk.agent.residence	Editorial.SmallTalk
quelle est ta ville	smalltalk.agent.residence	Editorial.SmallTalk
quelle est ta résidence	smalltalk.agent.residence	Editorial.SmallTalk
quelle est ta ville	smalltalk.agent.residence	Editorial.SmallTalk
quelle est ta ville	smalltalk.agent.residence	Editorial.SmallTalk
quelle est ta maison	smalltalk.agent.residence	Editorial.SmallTalk
où est ta maison	smalltalk.agent.residence	Editorial.SmallTalk
où est ta résidence	smalltalk.agent.residence	Editorial.SmallTalk
où est ta maison	smalltalk.agent.residence	Editorial.SmallTalk
où est ta ville natale	smalltalk.agent.residence	Editorial.SmallTalk
où est ta maison	smalltalk.agent.residence	Editorial.SmallTalk
où vous vivez	smalltalk.agent.residence	Editorial.SmallTalk
ta ville	smalltalk.agent.residence	Editorial.SmallTalk
votre ville	smalltalk.agent.residence	Editorial.SmallTalk
c'est vrai	smalltalk.agent.right	Editorial.SmallTalk
tu as raison	smalltalk.agent.right	Editorial.SmallTalk
tu as définitivement raison	smalltalk.agent.right	Editorial.SmallTalk
tu n'as pas tort	smalltalk.agent.right	Editorial.SmallTalk
tu dis la vérité	smalltalk.agent.right	Editorial.SmallTalk
ce que tu dis est vrai	smalltalk.agent.right	Editorial.SmallTalk
VRAI	smalltalk.agent.right	Editorial.SmallTalk
c'est vrai	smalltalk.agent.right	Editorial.SmallTalk
c'est juste	smalltalk.agent.right	Editorial.SmallTalk
c'est la vérité	smalltalk.agent.right	Editorial.SmallTalk
c'est vrai	smalltalk.agent.right	Editorial.SmallTalk
c'est exact	smalltalk.agent.right	Editorial.SmallTalk
c'est vrai	smalltalk.agent.right	Editorial.SmallTalk
c'est vrai	smalltalk.agent.right	Editorial.SmallTalk
c'est très vrai	smalltalk.agent.right	Editorial.SmallTalk
c'est tellement vrai	smalltalk.agent.right	Editorial.SmallTalk
vous avez raison	smalltalk.agent.right	Editorial.SmallTalk
tu as tellement raison	smalltalk.agent.right	Editorial.SmallTalk
vous avez absolument raison	smalltalk.agent.right	Editorial.SmallTalk
tu as raison à ce sujet	smalltalk.agent.right	Editorial.SmallTalk
Je sais que c'est vrai	smalltalk.agent.right	Editorial.SmallTalk
c'est correct	smalltalk.confirmation.yes	Editorial.SmallTalk
C'est bon	smalltalk.confirmation.yes	Editorial.SmallTalk
poursuivre	smalltalk.confirmation.yes	Editorial.SmallTalk
ça a l'air bien	smalltalk.confirmation.yes	Editorial.SmallTalk
d'accord	smalltalk.confirmation.yes	Editorial.SmallTalk
Oui	smalltalk.confirmation.yes	Editorial.SmallTalk
d'accord	smalltalk.confirmation.yes	Editorial.SmallTalk
Oki Doki	smalltalk.confirmation.yes	Editorial.SmallTalk
bien sûr	smalltalk.confirmation.yes	Editorial.SmallTalk
Allez-y	smalltalk.confirmation.yes	Editorial.SmallTalk
Ouais	smalltalk.confirmation.yes	Editorial.SmallTalk
ouais	smalltalk.confirmation.yes	Editorial.SmallTalk
fais-le	smalltalk.confirmation.yes	Editorial.SmallTalk
bien sûr	smalltalk.confirmation.yes	Editorial.SmallTalk
Je suppose	smalltalk.confirmation.yes	Editorial.SmallTalk
correct	smalltalk.confirmation.yes	Editorial.SmallTalk
Oui bien sûr	smalltalk.confirmation.yes	Editorial.SmallTalk
pourquoi pas	smalltalk.confirmation.yes	Editorial.SmallTalk
Je vous en prie	smalltalk.confirmation.yes	Editorial.SmallTalk
c'est sûr	smalltalk.confirmation.yes	Editorial.SmallTalk
Je suis d'accord	smalltalk.confirmation.yes	Editorial.SmallTalk
Cela ne me dérange pas	smalltalk.confirmation.yes	Editorial.SmallTalk
certainement	smalltalk.confirmation.yes	Editorial.SmallTalk
exactement	smalltalk.confirmation.yes	Editorial.SmallTalk
Oui je suis d'accord	smalltalk.confirmation.yes	Editorial.SmallTalk
Je pense que oui	smalltalk.confirmation.yes	Editorial.SmallTalk
oui c'est le cas	smalltalk.confirmation.yes	Editorial.SmallTalk
droite	smalltalk.confirmation.yes	Editorial.SmallTalk
ok alors	smalltalk.confirmation.yes	Editorial.SmallTalk
oui bien sûr	smalltalk.confirmation.yes	Editorial.SmallTalk
oui je le fais	smalltalk.confirmation.yes	Editorial.SmallTalk
c'est bon	smalltalk.confirmation.yes	Editorial.SmallTalk
Je fais	smalltalk.confirmation.yes	Editorial.SmallTalk
ouais	smalltalk.confirmation.yes	Editorial.SmallTalk
ouais	smalltalk.confirmation.yes	Editorial.SmallTalk
oh oui	smalltalk.confirmation.yes	Editorial.SmallTalk
oui bien sûr	smalltalk.confirmation.yes	Editorial.SmallTalk
évidemment	smalltalk.confirmation.yes	Editorial.SmallTalk
k	smalltalk.confirmation.yes	Editorial.SmallTalk
"bien sûr, pourquoi pas"	smalltalk.confirmation.yes	Editorial.SmallTalk
Oui en effet	smalltalk.confirmation.yes	Editorial.SmallTalk
"Ouais, bien sûr"	smalltalk.confirmation.yes	Editorial.SmallTalk
absolument	smalltalk.confirmation.yes	Editorial.SmallTalk
oui en effet	smalltalk.confirmation.yes	Editorial.SmallTalk
"OK, bien sûr"	smalltalk.confirmation.yes	Editorial.SmallTalk
OK oui	smalltalk.confirmation.yes	Editorial.SmallTalk
Oui correct	smalltalk.confirmation.yes	Editorial.SmallTalk
d'accord merci	smalltalk.confirmation.yes	Editorial.SmallTalk
chose sûre	smalltalk.confirmation.yes	Editorial.SmallTalk
vous	smalltalk.confirmation.yes	Editorial.SmallTalk
confirmer	smalltalk.confirmation.yes	Editorial.SmallTalk
ouais	smalltalk.confirmation.yes	Editorial.SmallTalk
Cela semble bon	smalltalk.confirmation.yes	Editorial.SmallTalk
Oui merci	smalltalk.confirmation.yes	Editorial.SmallTalk
certainement	smalltalk.confirmation.yes	Editorial.SmallTalk
"oui, c'est vrai"	smalltalk.confirmation.yes	Editorial.SmallTalk
Oui je voudrais	smalltalk.confirmation.yes	Editorial.SmallTalk
très bien	smalltalk.confirmation.yes	Editorial.SmallTalk
Oui définitivement	smalltalk.confirmation.yes	Editorial.SmallTalk
ouais	smalltalk.confirmation.yes	Editorial.SmallTalk
Oui c'est correct	smalltalk.confirmation.yes	Editorial.SmallTalk
Oui c'est vrai	smalltalk.confirmation.yes	Editorial.SmallTalk
OK tu peux	smalltalk.confirmation.yes	Editorial.SmallTalk
japper	smalltalk.confirmation.yes	Editorial.SmallTalk
Oui vous pouvez	smalltalk.confirmation.yes	Editorial.SmallTalk
confirmé	smalltalk.confirmation.yes	Editorial.SmallTalk
bien sûr pourquoi pas	smalltalk.confirmation.yes	Editorial.SmallTalk
Oui c'est bon	smalltalk.confirmation.yes	Editorial.SmallTalk
affirmative	smalltalk.confirmation.yes	Editorial.SmallTalk
"Ouais, vas-y"	smalltalk.confirmation.yes	Editorial.SmallTalk
"ouais, je suis sûr"	smalltalk.confirmation.yes	Editorial.SmallTalk
"Okay, ça a l'air bien"	smalltalk.confirmation.yes	Editorial.SmallTalk
OK c'est bon	smalltalk.confirmation.yes	Editorial.SmallTalk
Oui exactement	smalltalk.confirmation.yes	Editorial.SmallTalk
c'est ok	smalltalk.confirmation.yes	Editorial.SmallTalk
c'est correct	smalltalk.confirmation.yes	Editorial.SmallTalk
OK Vas y	smalltalk.confirmation.yes	Editorial.SmallTalk
oui c'est correct	smalltalk.confirmation.yes	Editorial.SmallTalk
"tant pis, ça va"	smalltalk.confirmation.yes	Editorial.SmallTalk
bien	smalltalk.confirmation.yes	Editorial.SmallTalk
Oui bien sûr	smalltalk.confirmation.yes	Editorial.SmallTalk
d'accord	smalltalk.confirmation.yes	Editorial.SmallTalk
es-tu sûr	smalltalk.agent.sure	Editorial.SmallTalk
es-tu sûr maintenant	smalltalk.agent.sure	Editorial.SmallTalk
es-tu sûr aujourd'hui	smalltalk.agent.sure	Editorial.SmallTalk
es-tu sûr maintenant	smalltalk.agent.sure	Editorial.SmallTalk
es-tu sûr ce soir	smalltalk.agent.sure	Editorial.SmallTalk
pourquoi tu ne me parles pas	smalltalk.agent.talk_to_me	Editorial.SmallTalk
voulez-vous discuter avec moi	smalltalk.agent.talk_to_me	Editorial.SmallTalk
Veux-tu me parler	smalltalk.agent.talk_to_me	Editorial.SmallTalk
parle moi	smalltalk.agent.talk_to_me	Editorial.SmallTalk
est-ce que tu vas me parler	smalltalk.agent.talk_to_me	Editorial.SmallTalk
C'est à moi que tu parles	smalltalk.agent.talk_to_me	Editorial.SmallTalk
pouvez-vous discuter avec moi	smalltalk.agent.talk_to_me	Editorial.SmallTalk
peux-tu me parler	smalltalk.agent.talk_to_me	Editorial.SmallTalk
peux-tu me parler	smalltalk.agent.talk_to_me	Editorial.SmallTalk
Pouvez-vous parler avec moi	smalltalk.agent.talk_to_me	Editorial.SmallTalk
dire	smalltalk.agent.talk_to_me	Editorial.SmallTalk
parler	smalltalk.agent.talk_to_me	Editorial.SmallTalk
discuter avec moi	smalltalk.agent.talk_to_me	Editorial.SmallTalk
discute juste avec moi	smalltalk.agent.talk_to_me	Editorial.SmallTalk
parle moi	smalltalk.agent.talk_to_me	Editorial.SmallTalk
parle avec moi	smalltalk.agent.talk_to_me	Editorial.SmallTalk
parle moi	smalltalk.agent.talk_to_me	Editorial.SmallTalk
pourquoi tu ne me parles pas	smalltalk.agent.talk_to_me	Editorial.SmallTalk
tu peux me parler	smalltalk.agent.talk_to_me	Editorial.SmallTalk
es-tu là	smalltalk.agent.there	Editorial.SmallTalk
Tu es là	smalltalk.agent.there	Editorial.SmallTalk
es-tu près de moi	smalltalk.agent.there	Editorial.SmallTalk
êtes-vous ici	smalltalk.agent.there	Editorial.SmallTalk
Vous êtes toujours là	smalltalk.agent.there	Editorial.SmallTalk
Tu es là	smalltalk.agent.there	Editorial.SmallTalk
tu es toujours là	smalltalk.agent.there	Editorial.SmallTalk
Êtes-vous toujours là	smalltalk.agent.there	Editorial.SmallTalk
plutot mauvais	smalltalk.appraisal.bad	Editorial.SmallTalk
pas assez bon	smalltalk.appraisal.bad	Editorial.SmallTalk
c'était nul	smalltalk.appraisal.bad	Editorial.SmallTalk
c'était terrible	smalltalk.appraisal.bad	Editorial.SmallTalk
c'est mauvais	smalltalk.appraisal.bad	Editorial.SmallTalk
c'est mauvais	smalltalk.appraisal.bad	Editorial.SmallTalk
c'est mauvais	smalltalk.appraisal.bad	Editorial.SmallTalk
pas bon	smalltalk.appraisal.bad	Editorial.SmallTalk
j'ai peur que ce soit mauvais	smalltalk.appraisal.bad	Editorial.SmallTalk
non c'est mauvais	smalltalk.appraisal.bad	Editorial.SmallTalk
c'était horrible	smalltalk.appraisal.bad	Editorial.SmallTalk
mauvais	smalltalk.appraisal.bad	Editorial.SmallTalk
dommage	smalltalk.appraisal.bad	Editorial.SmallTalk
c'est dommage	smalltalk.appraisal.bad	Editorial.SmallTalk
terrible	smalltalk.appraisal.bad	Editorial.SmallTalk
horrible	smalltalk.appraisal.bad	Editorial.SmallTalk
horrible	smalltalk.appraisal.bad	Editorial.SmallTalk
épouvantable	smalltalk.appraisal.bad	Editorial.SmallTalk
c'est mauvais	smalltalk.appraisal.bad	Editorial.SmallTalk
pas bien	smalltalk.appraisal.bad	Editorial.SmallTalk
c'était mauvais	smalltalk.appraisal.bad	Editorial.SmallTalk
c'était horrible	smalltalk.appraisal.bad	Editorial.SmallTalk
c'est nul	smalltalk.appraisal.bad	Editorial.SmallTalk
ce n'est pas bon	smalltalk.appraisal.bad	Editorial.SmallTalk
c'est terrible	smalltalk.appraisal.bad	Editorial.SmallTalk
c'est dommage	smalltalk.appraisal.bad	Editorial.SmallTalk
ce n'est pas bien	smalltalk.appraisal.bad	Editorial.SmallTalk
dommage	smalltalk.appraisal.bad	Editorial.SmallTalk
très mauvais	smalltalk.appraisal.bad	Editorial.SmallTalk
mauvaise fille	smalltalk.appraisal.bad	Editorial.SmallTalk
Ce n'est pas bon	smalltalk.appraisal.bad	Editorial.SmallTalk
pas si bon	smalltalk.appraisal.bad	Editorial.SmallTalk
c'est tres mal	smalltalk.appraisal.bad	Editorial.SmallTalk
c'est dommage	smalltalk.appraisal.bad	Editorial.SmallTalk
ce n'est pas assez bien	smalltalk.appraisal.bad	Editorial.SmallTalk
Et bien c'est dommage	smalltalk.appraisal.bad	Editorial.SmallTalk
mauvais Très mauvais	smalltalk.appraisal.bad	Editorial.SmallTalk
c'est tellement mauvais	smalltalk.appraisal.bad	Editorial.SmallTalk
vraiment mauvais	smalltalk.appraisal.bad	Editorial.SmallTalk
c'est vraiment mauvais	smalltalk.appraisal.bad	Editorial.SmallTalk
mauvaise idée	smalltalk.appraisal.bad	Editorial.SmallTalk
c'est mauvais	smalltalk.appraisal.bad	Editorial.SmallTalk
ce n'était pas bon	smalltalk.appraisal.bad	Editorial.SmallTalk
ce n'est pas si bon	smalltalk.appraisal.bad	Editorial.SmallTalk
pas un bon	smalltalk.appraisal.bad	Editorial.SmallTalk
"Oh, ce n'est pas bon"	smalltalk.appraisal.bad	Editorial.SmallTalk
pas trop bon	smalltalk.appraisal.bad	Editorial.SmallTalk
tellement nul	smalltalk.appraisal.bad	Editorial.SmallTalk
c'est vraiment mauvais	smalltalk.appraisal.bad	Editorial.SmallTalk
c'est dommage	smalltalk.appraisal.bad	Editorial.SmallTalk
mauvais vraiment mauvais	smalltalk.appraisal.bad	Editorial.SmallTalk
trop cool	smalltalk.appraisal.good	Editorial.SmallTalk
cool	smalltalk.appraisal.good	Editorial.SmallTalk
c'est bon	smalltalk.appraisal.good	Editorial.SmallTalk
content de l'entendre	smalltalk.appraisal.good	Editorial.SmallTalk
c'est très gentil de ta part	smalltalk.appraisal.good	Editorial.SmallTalk
formidable	smalltalk.appraisal.good	Editorial.SmallTalk
c'est incroyable	smalltalk.appraisal.good	Editorial.SmallTalk
c'est génial	smalltalk.appraisal.good	Editorial.SmallTalk
parfait	smalltalk.appraisal.good	Editorial.SmallTalk
excellent	smalltalk.appraisal.good	Editorial.SmallTalk
c'est super	smalltalk.appraisal.good	Editorial.SmallTalk
c'est bon	smalltalk.appraisal.good	Editorial.SmallTalk
c'est bien	smalltalk.appraisal.good	Editorial.SmallTalk
bien	smalltalk.appraisal.good	Editorial.SmallTalk
bien	smalltalk.appraisal.good	Editorial.SmallTalk
bon	smalltalk.appraisal.good	Editorial.SmallTalk
C'est très bien	smalltalk.appraisal.good	Editorial.SmallTalk
très bien	smalltalk.appraisal.good	Editorial.SmallTalk
incroyable	smalltalk.appraisal.good	Editorial.SmallTalk
fantastique	smalltalk.appraisal.good	Editorial.SmallTalk
super	smalltalk.appraisal.good	Editorial.SmallTalk
bon très bon	smalltalk.appraisal.good	Editorial.SmallTalk
c'est très bien	smalltalk.appraisal.good	Editorial.SmallTalk
très bien	smalltalk.appraisal.good	Editorial.SmallTalk
c'est bon	smalltalk.appraisal.good	Editorial.SmallTalk
c'est bon	smalltalk.appraisal.good	Editorial.SmallTalk
c'est parfait	smalltalk.appraisal.good	Editorial.SmallTalk
beaucoup mieux	smalltalk.appraisal.good	Editorial.SmallTalk
pas mal	smalltalk.appraisal.good	Editorial.SmallTalk
pas mal	smalltalk.appraisal.good	Editorial.SmallTalk
c'est très bien	smalltalk.appraisal.good	Editorial.SmallTalk
merveilleux	smalltalk.appraisal.good	Editorial.SmallTalk
c'est bien	smalltalk.appraisal.good	Editorial.SmallTalk
agréable	smalltalk.appraisal.good	Editorial.SmallTalk
très bon	smalltalk.appraisal.good	Editorial.SmallTalk
vraiment sympa	smalltalk.appraisal.good	Editorial.SmallTalk
splendide	smalltalk.appraisal.good	Editorial.SmallTalk
droit	smalltalk.appraisal.good	Editorial.SmallTalk
super	smalltalk.appraisal.good	Editorial.SmallTalk
super fantastique	smalltalk.appraisal.good	Editorial.SmallTalk
doux	smalltalk.appraisal.good	Editorial.SmallTalk
vraiment bien	smalltalk.appraisal.good	Editorial.SmallTalk
très bien	smalltalk.appraisal.good	Editorial.SmallTalk
c'est génial	smalltalk.appraisal.good	Editorial.SmallTalk
C'est bien	smalltalk.appraisal.good	Editorial.SmallTalk
c'est merveilleux	smalltalk.appraisal.good	Editorial.SmallTalk
c'était incroyable	smalltalk.appraisal.good	Editorial.SmallTalk
c'était génial	smalltalk.appraisal.good	Editorial.SmallTalk
c'était mignon	smalltalk.appraisal.good	Editorial.SmallTalk
c'était plutôt bien	smalltalk.appraisal.good	Editorial.SmallTalk
c'était très bien	smalltalk.appraisal.good	Editorial.SmallTalk
c'est une bonne idée	smalltalk.appraisal.good	Editorial.SmallTalk
c'est une bonne chose	smalltalk.appraisal.good	Editorial.SmallTalk
c'est incroyable	smalltalk.appraisal.good	Editorial.SmallTalk
c'est génial merci	smalltalk.appraisal.good	Editorial.SmallTalk
c'est mieux	smalltalk.appraisal.good	Editorial.SmallTalk
c'est mignon	smalltalk.appraisal.good	Editorial.SmallTalk
c'est fantastique	smalltalk.appraisal.good	Editorial.SmallTalk
c'est beaucoup mieux	smalltalk.appraisal.good	Editorial.SmallTalk
c'est gentil de ta part	smalltalk.appraisal.good	Editorial.SmallTalk
c'est pas mal	smalltalk.appraisal.good	Editorial.SmallTalk
C'est parfait	smalltalk.appraisal.good	Editorial.SmallTalk
c'est plutôt bien	smalltalk.appraisal.good	Editorial.SmallTalk
c'est vraiment bon	smalltalk.appraisal.good	Editorial.SmallTalk
c'est vraiment sympathique	smalltalk.appraisal.good	Editorial.SmallTalk
c'est gentil de ta part	smalltalk.appraisal.good	Editorial.SmallTalk
c'est très gentil	smalltalk.appraisal.good	Editorial.SmallTalk
c'est merveilleux	smalltalk.appraisal.good	Editorial.SmallTalk
C'est génial	smalltalk.appraisal.good	Editorial.SmallTalk
c'est bon	smalltalk.appraisal.good	Editorial.SmallTalk
c'est bien	smalltalk.appraisal.good	Editorial.SmallTalk
très agréable	smalltalk.appraisal.good	Editorial.SmallTalk
très alors	smalltalk.appraisal.good	Editorial.SmallTalk
merveilleux	smalltalk.appraisal.good	Editorial.SmallTalk
Je suis content de l'entendre	smalltalk.appraisal.good	Editorial.SmallTalk
OK bien	smalltalk.appraisal.good	Editorial.SmallTalk
Bien pour vous	smalltalk.appraisal.good	Editorial.SmallTalk
bon à savoir	smalltalk.appraisal.good	Editorial.SmallTalk
content de l'entendre	smalltalk.appraisal.good	Editorial.SmallTalk
si bon	smalltalk.appraisal.good	Editorial.SmallTalk
si gentil de ta part	smalltalk.appraisal.good	Editorial.SmallTalk
c'était bon	smalltalk.appraisal.good	Editorial.SmallTalk
tant pis	smalltalk.appraisal.good	Editorial.SmallTalk
bonne chose	smalltalk.appraisal.good	Editorial.SmallTalk
c'était bien	smalltalk.appraisal.good	Editorial.SmallTalk
c'est génial	smalltalk.appraisal.good	Editorial.SmallTalk
"d'accord, bien"	smalltalk.appraisal.good	Editorial.SmallTalk
non c'est bon	smalltalk.appraisal.good	Editorial.SmallTalk
C'est très bien	smalltalk.appraisal.good	Editorial.SmallTalk
pas de soucis	smalltalk.appraisal.no_problem	Editorial.SmallTalk
pas de problème	smalltalk.appraisal.no_problem	Editorial.SmallTalk
aucun problème	smalltalk.appraisal.no_problem	Editorial.SmallTalk
il n'y a aucun problème	smalltalk.appraisal.no_problem	Editorial.SmallTalk
bien sûr pas de problème	smalltalk.appraisal.no_problem	Editorial.SmallTalk
pas de problème à ce sujet	smalltalk.appraisal.no_problem	Editorial.SmallTalk
Ne vous inquiétez pas	smalltalk.appraisal.no_problem	Editorial.SmallTalk
"ne t'inquiète pas, il n'y a pas de problème"	smalltalk.appraisal.no_problem	Editorial.SmallTalk
tu as beaucoup aidé merci	smalltalk.appraisal.thank_you	Editorial.SmallTalk
apprécier ton aide	smalltalk.appraisal.thank_you	Editorial.SmallTalk
acclamations	smalltalk.appraisal.thank_you	Editorial.SmallTalk
merci	smalltalk.appraisal.thank_you	Editorial.SmallTalk
merci	smalltalk.appraisal.thank_you	Editorial.SmallTalk
merci beaucoup	smalltalk.appraisal.thank_you	Editorial.SmallTalk
génial merci	smalltalk.appraisal.thank_you	Editorial.SmallTalk
super merci	smalltalk.appraisal.thank_you	Editorial.SmallTalk
Merci beaucoup	smalltalk.appraisal.thank_you	Editorial.SmallTalk
merci beaucoup	smalltalk.appraisal.thank_you	Editorial.SmallTalk
Merci pour votre aide	smalltalk.appraisal.thank_you	Editorial.SmallTalk
Merci pour votre aide	smalltalk.appraisal.thank_you	Editorial.SmallTalk
bien merci	smalltalk.appraisal.thank_you	Editorial.SmallTalk
je l'apprécie	smalltalk.appraisal.thank_you	Editorial.SmallTalk
Je te remercie	smalltalk.appraisal.thank_you	Editorial.SmallTalk
merci ce sera tout	smalltalk.appraisal.thank_you	Editorial.SmallTalk
Merci mon pote	smalltalk.appraisal.thank_you	Editorial.SmallTalk
Merci mon amour	smalltalk.appraisal.thank_you	Editorial.SmallTalk
Merci mon ami	smalltalk.appraisal.thank_you	Editorial.SmallTalk
bien merci	smalltalk.appraisal.thank_you	Editorial.SmallTalk
très bien merci	smalltalk.appraisal.thank_you	Editorial.SmallTalk
bien merci	smalltalk.appraisal.thank_you	Editorial.SmallTalk
Merci encore	smalltalk.appraisal.thank_you	Editorial.SmallTalk
Merci encore	smalltalk.appraisal.thank_you	Editorial.SmallTalk
merci à tous	smalltalk.appraisal.thank_you	Editorial.SmallTalk
très bien merci	smalltalk.appraisal.thank_you	Editorial.SmallTalk
d'accord merci	smalltalk.appraisal.thank_you	Editorial.SmallTalk
non merci c'est tout	smalltalk.appraisal.thank_you	Editorial.SmallTalk
"parfait, merci"	smalltalk.appraisal.thank_you	Editorial.SmallTalk
c'est gentil de ta part	smalltalk.appraisal.thank_you	Editorial.SmallTalk
bien merci	smalltalk.appraisal.thank_you	Editorial.SmallTalk
merci	smalltalk.appraisal.thank_you	Editorial.SmallTalk
merci	smalltalk.appraisal.thank_you	Editorial.SmallTalk
Tout le plaisir est pour moi	smalltalk.appraisal.welcome	Editorial.SmallTalk
avec plaisir	smalltalk.appraisal.welcome	Editorial.SmallTalk
à tout moment	smalltalk.appraisal.welcome	Editorial.SmallTalk
accueillir	smalltalk.appraisal.welcome	Editorial.SmallTalk
vous êtes les bienvenus	smalltalk.appraisal.welcome	Editorial.SmallTalk
"bien sûr, bienvenue"	smalltalk.appraisal.welcome	Editorial.SmallTalk
Bienvenue ici	smalltalk.appraisal.welcome	Editorial.SmallTalk
tu es le bienvenu	smalltalk.appraisal.welcome	Editorial.SmallTalk
tout ce que tu veux	smalltalk.appraisal.welcome	Editorial.SmallTalk
bon travail	smalltalk.appraisal.well_done	Editorial.SmallTalk
bon travail	smalltalk.appraisal.well_done	Editorial.SmallTalk
marche à suivre	smalltalk.appraisal.well_done	Editorial.SmallTalk
bien joué	smalltalk.appraisal.well_done	Editorial.SmallTalk
bon travail	smalltalk.appraisal.well_done	Editorial.SmallTalk
bon travail	smalltalk.appraisal.well_done	Editorial.SmallTalk
excellent travail	smalltalk.appraisal.well_done	Editorial.SmallTalk
Bravo	smalltalk.appraisal.well_done	Editorial.SmallTalk
bon travail	smalltalk.appraisal.well_done	Editorial.SmallTalk
Annuler	smalltalk.confirmation.cancel	Editorial.SmallTalk
avorter	smalltalk.confirmation.cancel	Editorial.SmallTalk
annuler	smalltalk.confirmation.cancel	Editorial.SmallTalk
annule ça	smalltalk.confirmation.cancel	Editorial.SmallTalk
demande d'annulation	smalltalk.confirmation.cancel	Editorial.SmallTalk
annulé	smalltalk.confirmation.cancel	Editorial.SmallTalk
rejeter	smalltalk.confirmation.cancel	Editorial.SmallTalk
rejeté	smalltalk.confirmation.cancel	Editorial.SmallTalk
mépris	smalltalk.confirmation.cancel	Editorial.SmallTalk
ignorer cela	smalltalk.confirmation.cancel	Editorial.SmallTalk
sauter	smalltalk.confirmation.cancel	Editorial.SmallTalk
sauter	smalltalk.confirmation.cancel	Editorial.SmallTalk
tout annuler	smalltalk.confirmation.cancel	Editorial.SmallTalk
Tout annuler	smalltalk.confirmation.cancel	Editorial.SmallTalk
oublie ça	smalltalk.confirmation.cancel	Editorial.SmallTalk
oublier	smalltalk.confirmation.cancel	Editorial.SmallTalk
ne fais pas ça	smalltalk.confirmation.cancel	Editorial.SmallTalk
arrêt	smalltalk.confirmation.cancel	Editorial.SmallTalk
oublie ça	smalltalk.confirmation.cancel	Editorial.SmallTalk
oublie ça	smalltalk.confirmation.cancel	Editorial.SmallTalk
jeter	smalltalk.confirmation.cancel	Editorial.SmallTalk
oublie ça	smalltalk.confirmation.cancel	Editorial.SmallTalk
Oublie ça	smalltalk.confirmation.cancel	Editorial.SmallTalk
oublie ça	smalltalk.confirmation.cancel	Editorial.SmallTalk
j'ai dit annuler	smalltalk.confirmation.cancel	Editorial.SmallTalk
il suffit de l'annuler	smalltalk.confirmation.cancel	Editorial.SmallTalk
rien n'annule	smalltalk.confirmation.cancel	Editorial.SmallTalk
arrête juste ça	smalltalk.confirmation.cancel	Editorial.SmallTalk
pas d'annulation annuler	smalltalk.confirmation.cancel	Editorial.SmallTalk
"non, il suffit d'annuler"	smalltalk.confirmation.cancel	Editorial.SmallTalk
annuler ma demande	smalltalk.confirmation.cancel	Editorial.SmallTalk
peux-tu annuler ça	smalltalk.confirmation.cancel	Editorial.SmallTalk
annuler tout ça	smalltalk.confirmation.cancel	Editorial.SmallTalk
annuler cette demande	smalltalk.confirmation.cancel	Editorial.SmallTalk
"non, annule ça"	smalltalk.confirmation.cancel	Editorial.SmallTalk
"non, tout annuler"	smalltalk.confirmation.cancel	Editorial.SmallTalk
pas d'arrêt	smalltalk.confirmation.cancel	Editorial.SmallTalk
juste oublier	smalltalk.confirmation.cancel	Editorial.SmallTalk
je veux annuler	smalltalk.confirmation.cancel	Editorial.SmallTalk
"tant pis, oublie ça"	smalltalk.confirmation.cancel	Editorial.SmallTalk
"non, annule-le simplement"	smalltalk.confirmation.cancel	Editorial.SmallTalk
"rien, oublie-le"	smalltalk.confirmation.cancel	Editorial.SmallTalk
j'ai dit d'annuler	smalltalk.confirmation.cancel	Editorial.SmallTalk
annuler tout ça	smalltalk.confirmation.cancel	Editorial.SmallTalk
peux-tu l'annuler	smalltalk.confirmation.cancel	Editorial.SmallTalk
alors annule	smalltalk.confirmation.cancel	Editorial.SmallTalk
j'ai dit oublie ça	smalltalk.confirmation.cancel	Editorial.SmallTalk
annuler tout ça	smalltalk.confirmation.cancel	Editorial.SmallTalk
"oublie ça, tant pis"	smalltalk.confirmation.cancel	Editorial.SmallTalk
arrête ça	smalltalk.confirmation.cancel	Editorial.SmallTalk
je veux l'annuler	smalltalk.confirmation.cancel	Editorial.SmallTalk
je voudrais annuler	smalltalk.confirmation.cancel	Editorial.SmallTalk
maintenant annuler	smalltalk.confirmation.cancel	Editorial.SmallTalk
annuler maintenant	smalltalk.confirmation.cancel	Editorial.SmallTalk
désolé annuler	smalltalk.confirmation.cancel	Editorial.SmallTalk
annuler celui-là	smalltalk.confirmation.cancel	Editorial.SmallTalk
sauter sauter sauter	smalltalk.confirmation.cancel	Editorial.SmallTalk
annule-le annule-le	smalltalk.confirmation.cancel	Editorial.SmallTalk
annuler cela annuler cela	smalltalk.confirmation.cancel	Editorial.SmallTalk
ne fais rien	smalltalk.confirmation.cancel	Editorial.SmallTalk
J'ai dit annuler annuler	smalltalk.confirmation.cancel	Editorial.SmallTalk
mais peux-tu l'annuler	smalltalk.confirmation.cancel	Editorial.SmallTalk
et si non	smalltalk.confirmation.no	Editorial.SmallTalk
je n'ai aucun sens	smalltalk.confirmation.no	Editorial.SmallTalk
Non	smalltalk.confirmation.no	Editorial.SmallTalk
ne le faites pas	smalltalk.confirmation.no	Editorial.SmallTalk
je ne veux pas de ça	smalltalk.confirmation.no	Editorial.SmallTalk
je ne suis pas d'accord	smalltalk.confirmation.no	Editorial.SmallTalk
être en désaccord	smalltalk.confirmation.no	Editorial.SmallTalk
je ne veux pas	smalltalk.confirmation.no	Editorial.SmallTalk
pas intéressé	smalltalk.confirmation.no	Editorial.SmallTalk
Je ne pense pas	smalltalk.confirmation.no	Editorial.SmallTalk
certainement pas	smalltalk.confirmation.no	Editorial.SmallTalk
"non, ce n'est pas le cas"	smalltalk.confirmation.no	Editorial.SmallTalk
"non, je ne le fais pas"	smalltalk.confirmation.no	Editorial.SmallTalk
je ne suis pas	smalltalk.confirmation.no	Editorial.SmallTalk
n / A	smalltalk.confirmation.no	Editorial.SmallTalk
non c'est bien merci	smalltalk.confirmation.no	Editorial.SmallTalk
jamais	smalltalk.confirmation.no	Editorial.SmallTalk
j'ai dit non	smalltalk.confirmation.no	Editorial.SmallTalk
Bien sûr que non	smalltalk.confirmation.no	Editorial.SmallTalk
non	smalltalk.confirmation.no	Editorial.SmallTalk
pas de réservoirs	smalltalk.confirmation.no	Editorial.SmallTalk
non jamais	smalltalk.confirmation.no	Editorial.SmallTalk
pas besoin	smalltalk.confirmation.no	Editorial.SmallTalk
non merci	smalltalk.confirmation.no	Editorial.SmallTalk
non désolé	smalltalk.confirmation.no	Editorial.SmallTalk
ne pas	smalltalk.confirmation.no	Editorial.SmallTalk
pas aujourd'hui	smalltalk.confirmation.no	Editorial.SmallTalk
non ce n'est pas	smalltalk.confirmation.no	Editorial.SmallTalk
absolument pas	smalltalk.confirmation.no	Editorial.SmallTalk
pas ça	smalltalk.confirmation.no	Editorial.SmallTalk
non	smalltalk.confirmation.no	Editorial.SmallTalk
non	smalltalk.confirmation.no	Editorial.SmallTalk
je ne veux pas	smalltalk.confirmation.no	Editorial.SmallTalk
"non, je ne le ferais pas"	smalltalk.confirmation.no	Editorial.SmallTalk
il ne faut pas	smalltalk.confirmation.no	Editorial.SmallTalk
pas besoin	smalltalk.confirmation.no	Editorial.SmallTalk
pas cette fois	smalltalk.confirmation.no	Editorial.SmallTalk
"non, ne fais pas ça"	smalltalk.confirmation.no	Editorial.SmallTalk
"Merci mais, non merci"	smalltalk.confirmation.no	Editorial.SmallTalk
non c'est faux	smalltalk.confirmation.no	Editorial.SmallTalk
pas ça	smalltalk.confirmation.no	Editorial.SmallTalk
définitivement pas	smalltalk.confirmation.no	Editorial.SmallTalk
pas en ce moment	smalltalk.confirmation.no	Editorial.SmallTalk
pas exactement	smalltalk.confirmation.no	Editorial.SmallTalk
"non, non"	smalltalk.confirmation.no	Editorial.SmallTalk
"Non, pas vraiment"	smalltalk.confirmation.no	Editorial.SmallTalk
non merci pas maintenant	smalltalk.confirmation.no	Editorial.SmallTalk
En fait non	smalltalk.confirmation.no	Editorial.SmallTalk
"non, laisse tomber"	smalltalk.confirmation.no	Editorial.SmallTalk
non désolé	smalltalk.confirmation.no	Editorial.SmallTalk
non incorrect	smalltalk.confirmation.no	Editorial.SmallTalk
Non désolé	smalltalk.confirmation.no	Editorial.SmallTalk
Je dis NON	smalltalk.confirmation.no	Editorial.SmallTalk
pas vraiment	smalltalk.confirmation.no	Editorial.SmallTalk
pas maintenant merci	smalltalk.confirmation.no	Editorial.SmallTalk
je pense que non	smalltalk.confirmation.no	Editorial.SmallTalk
absolument pas	smalltalk.confirmation.no	Editorial.SmallTalk
non en fait	smalltalk.confirmation.no	Editorial.SmallTalk
apparemment non	smalltalk.confirmation.no	Editorial.SmallTalk
"non, ne fais pas ça"	smalltalk.confirmation.no	Editorial.SmallTalk
"Non, juste non"	smalltalk.confirmation.no	Editorial.SmallTalk
non mais merci	smalltalk.confirmation.no	Editorial.SmallTalk
Pas besoin merci	smalltalk.confirmation.no	Editorial.SmallTalk
non merci cependant	smalltalk.confirmation.no	Editorial.SmallTalk
Non merci beaucoup	smalltalk.confirmation.no	Editorial.SmallTalk
non merci pas maintenant	smalltalk.confirmation.no	Editorial.SmallTalk
pas oublier	smalltalk.confirmation.no	Editorial.SmallTalk
Attends une seconde	smalltalk.dialog.hold_on	Editorial.SmallTalk
pourrais-tu attendre	smalltalk.dialog.hold_on	Editorial.SmallTalk
attendez s'il vous plaît	smalltalk.dialog.hold_on	Editorial.SmallTalk
attendez	smalltalk.dialog.hold_on	Editorial.SmallTalk
attendez	smalltalk.dialog.hold_on	Editorial.SmallTalk
"Oh, attendez"	smalltalk.dialog.hold_on	Editorial.SmallTalk
Attendez	smalltalk.dialog.hold_on	Editorial.SmallTalk
ne te précipite pas	smalltalk.dialog.hold_on	Editorial.SmallTalk
je veux un câlin	smalltalk.dialog.hug	Editorial.SmallTalk
te câliner	smalltalk.dialog.hug	Editorial.SmallTalk
Veux-tu un câlin	smalltalk.dialog.hug	Editorial.SmallTalk
puis-je te faire un calin	smalltalk.dialog.hug	Editorial.SmallTalk
pourrais-tu me faire un câlin	smalltalk.dialog.hug	Editorial.SmallTalk
je veux un calin	smalltalk.dialog.hug	Editorial.SmallTalk
câlin	smalltalk.dialog.hug	Editorial.SmallTalk
embrasse moi	smalltalk.dialog.hug	Editorial.SmallTalk
étreint	smalltalk.dialog.hug	Editorial.SmallTalk
tu as fait un câlin	smalltalk.dialog.hug	Editorial.SmallTalk
étreindre	smalltalk.dialog.hug	Editorial.SmallTalk
en train de me faire un câlin	smalltalk.dialog.hug	Editorial.SmallTalk
m'a étreint	smalltalk.dialog.hug	Editorial.SmallTalk
Je veux un câlin	smalltalk.dialog.hug	Editorial.SmallTalk
un câlin	smalltalk.dialog.hug	Editorial.SmallTalk
Je m'en fiche	smalltalk.dialog.i_do_not_care	Editorial.SmallTalk
Je ne devrais pas m'en soucier	smalltalk.dialog.i_do_not_care	Editorial.SmallTalk
peu importe	smalltalk.dialog.i_do_not_care	Editorial.SmallTalk
je m'en fiche	smalltalk.dialog.i_do_not_care	Editorial.SmallTalk
Je m'en fiche du tout	smalltalk.dialog.i_do_not_care	Editorial.SmallTalk
je ne m'en soucie pas	smalltalk.dialog.i_do_not_care	Editorial.SmallTalk
je m'en fous du tout	smalltalk.dialog.i_do_not_care	Editorial.SmallTalk
je m'en fiche du tout	smalltalk.dialog.i_do_not_care	Editorial.SmallTalk
je ne m'en soucie pas du tout	smalltalk.dialog.i_do_not_care	Editorial.SmallTalk
excusez-moi	smalltalk.dialog.sorry	Editorial.SmallTalk
s'excuser	smalltalk.dialog.sorry	Editorial.SmallTalk
je m'excuse	smalltalk.dialog.sorry	Editorial.SmallTalk
Désolé	smalltalk.dialog.sorry	Editorial.SmallTalk
Je suis désolé	smalltalk.dialog.sorry	Editorial.SmallTalk
je suis tellement désolé	smalltalk.dialog.sorry	Editorial.SmallTalk
mes excuses	smalltalk.dialog.sorry	Editorial.SmallTalk
excuses	smalltalk.dialog.sorry	Editorial.SmallTalk
excuses pour moi	smalltalk.dialog.sorry	Editorial.SmallTalk
excuses	smalltalk.dialog.sorry	Editorial.SmallTalk
excuse	smalltalk.dialog.sorry	Editorial.SmallTalk
Je vous demande pardon	smalltalk.dialog.sorry	Editorial.SmallTalk
pardon	smalltalk.dialog.sorry	Editorial.SmallTalk
J'ai dit désolé	smalltalk.dialog.sorry	Editorial.SmallTalk
Je suis vraiment désolé	smalltalk.dialog.sorry	Editorial.SmallTalk
pardonne-moi	smalltalk.dialog.sorry	Editorial.SmallTalk
Désolé pour ça	smalltalk.dialog.sorry	Editorial.SmallTalk
Désolé pour ça	smalltalk.dialog.sorry	Editorial.SmallTalk
Désolé	smalltalk.dialog.sorry	Editorial.SmallTalk
Vraiment désolé	smalltalk.dialog.sorry	Editorial.SmallTalk
D'accord désolé	smalltalk.dialog.sorry	Editorial.SmallTalk
je veux dire désolé	smalltalk.dialog.sorry	Editorial.SmallTalk
"ok, je suis désolé"	smalltalk.dialog.sorry	Editorial.SmallTalk
OK je suis désolé	smalltalk.dialog.sorry	Editorial.SmallTalk
Que veux-tu dire exactement	smalltalk.dialog.what_do_you_mean	Editorial.SmallTalk
que veux-tu dire	smalltalk.dialog.what_do_you_mean	Editorial.SmallTalk
c'est ce que tu veux dire	smalltalk.dialog.what_do_you_mean	Editorial.SmallTalk
que voulez-vous dire exactement	smalltalk.dialog.what_do_you_mean	Editorial.SmallTalk
mais que veux-tu dire	smalltalk.dialog.what_do_you_mean	Editorial.SmallTalk
c'était faux	smalltalk.dialog.wrong	Editorial.SmallTalk
ce n'est pas ce que j'ai demandé	smalltalk.dialog.wrong	Editorial.SmallTalk
c'est faux	smalltalk.dialog.wrong	Editorial.SmallTalk
faux	smalltalk.dialog.wrong	Editorial.SmallTalk
Ce n'est pas correct	smalltalk.dialog.wrong	Editorial.SmallTalk
Ce n'est pas juste	smalltalk.dialog.wrong	Editorial.SmallTalk
c'est faux	smalltalk.dialog.wrong	Editorial.SmallTalk
c'est incorrect	smalltalk.dialog.wrong	Editorial.SmallTalk
Incorrect	smalltalk.dialog.wrong	Editorial.SmallTalk
Pas correcte	smalltalk.dialog.wrong	Editorial.SmallTalk
Vous avez tort	smalltalk.dialog.wrong	Editorial.SmallTalk
Pas vrai	smalltalk.dialog.wrong	Editorial.SmallTalk
hein	smalltalk.emotions.ha_ha	Editorial.SmallTalk
mdr	smalltalk.emotions.ha_ha	Editorial.SmallTalk
xd	smalltalk.emotions.ha_ha	Editorial.SmallTalk
ha ha	smalltalk.emotions.ha_ha	Editorial.SmallTalk
ahahah	smalltalk.emotions.ha_ha	Editorial.SmallTalk
ahah mdr	smalltalk.emotions.ha_ha	Editorial.SmallTalk
rire aux éclats	smalltalk.emotions.ha_ha	Editorial.SmallTalk
LMAO	smalltalk.emotions.ha_ha	Editorial.SmallTalk
Ca c'est drôle	smalltalk.emotions.ha_ha	Editorial.SmallTalk
ah	smalltalk.emotions.ha_ha	Editorial.SmallTalk
ah ah ah	smalltalk.emotions.ha_ha	Editorial.SmallTalk
Ah ah	smalltalk.emotions.ha_ha	Editorial.SmallTalk
ahaha	smalltalk.emotions.ha_ha	Editorial.SmallTalk
ahahaha	smalltalk.emotions.ha_ha	Editorial.SmallTalk
Ha	smalltalk.emotions.ha_ha	Editorial.SmallTalk
hahaha	smalltalk.emotions.ha_ha	Editorial.SmallTalk
ha ha ha ha	smalltalk.emotions.ha_ha	Editorial.SmallTalk
hah	smalltalk.emotions.ha_ha	Editorial.SmallTalk
haha	smalltalk.emotions.ha_ha	Editorial.SmallTalk
haha drôle	smalltalk.emotions.ha_ha	Editorial.SmallTalk
haha haha haha	smalltalk.emotions.ha_ha	Editorial.SmallTalk
haha c'est drôle	smalltalk.emotions.ha_ha	Editorial.SmallTalk
haha très drôle	smalltalk.emotions.ha_ha	Editorial.SmallTalk
hahaha	smalltalk.emotions.ha_ha	Editorial.SmallTalk
hahaha c'est drôle	smalltalk.emotions.ha_ha	Editorial.SmallTalk
hahaha très drôle	smalltalk.emotions.ha_ha	Editorial.SmallTalk
il	smalltalk.emotions.ha_ha	Editorial.SmallTalk
héhé	smalltalk.emotions.ha_ha	Editorial.SmallTalk
héhéhé	smalltalk.emotions.ha_ha	Editorial.SmallTalk
lmao	smalltalk.emotions.ha_ha	Editorial.SmallTalk
Ouah	smalltalk.emotions.wow	Editorial.SmallTalk
Wow Wow	smalltalk.emotions.wow	Editorial.SmallTalk
Waouh Waouh Waouh	smalltalk.emotions.wow	Editorial.SmallTalk
wooow	smalltalk.emotions.wow	Editorial.SmallTalk
ouah	smalltalk.emotions.wow	Editorial.SmallTalk
d'accord on se voit plus tard	smalltalk.greetings.bye	Editorial.SmallTalk
j'espère te voir plus tard	smalltalk.greetings.bye	Editorial.SmallTalk
au revoir pour l'instant	smalltalk.greetings.bye	Editorial.SmallTalk
jusqu'à la prochaine fois	smalltalk.greetings.bye	Editorial.SmallTalk
je dois y aller	smalltalk.greetings.bye	Editorial.SmallTalk
au revoir	smalltalk.greetings.bye	Editorial.SmallTalk
au revoir	smalltalk.greetings.bye	Editorial.SmallTalk
à bientôt	smalltalk.greetings.bye	Editorial.SmallTalk
à bientôt	smalltalk.greetings.bye	Editorial.SmallTalk
Bye Bye	smalltalk.greetings.bye	Editorial.SmallTalk
au revoir	smalltalk.greetings.bye	Editorial.SmallTalk
"Au revoir, à bientôt"	smalltalk.greetings.bye	Editorial.SmallTalk
au revoir à bientôt	smalltalk.greetings.bye	Editorial.SmallTalk
Au revoir prends soin de toi	smalltalk.greetings.bye	Editorial.SmallTalk
J'ai dit au revoir	smalltalk.greetings.bye	Editorial.SmallTalk
peu importe au revoir	smalltalk.greetings.bye	Editorial.SmallTalk
maintenant au revoir	smalltalk.greetings.bye	Editorial.SmallTalk
c'est tout au revoir	smalltalk.greetings.bye	Editorial.SmallTalk
c'est tout au revoir	smalltalk.greetings.bye	Editorial.SmallTalk
laisse-moi tranquille	smalltalk.greetings.bye	Editorial.SmallTalk
aller au lit	smalltalk.greetings.bye	Editorial.SmallTalk
au revoir pour le moment	smalltalk.greetings.bye	Editorial.SmallTalk
on se parle plus tard	smalltalk.greetings.bye	Editorial.SmallTalk
tu peux partir maintenant	smalltalk.greetings.bye	Editorial.SmallTalk
Aller se faire cuire un œuf	smalltalk.greetings.bye	Editorial.SmallTalk
au revoir à tout à l'heure	smalltalk.greetings.bye	Editorial.SmallTalk
d'accord au revoir	smalltalk.greetings.bye	Editorial.SmallTalk
à plus	smalltalk.greetings.bye	Editorial.SmallTalk
merci au revoir	smalltalk.greetings.bye	Editorial.SmallTalk
Okay au revoir	smalltalk.greetings.bye	Editorial.SmallTalk
ok merci au revoir	smalltalk.greetings.bye	Editorial.SmallTalk
à demain	smalltalk.greetings.bye	Editorial.SmallTalk
OK au revoir	smalltalk.greetings.bye	Editorial.SmallTalk
bonne soirée	smalltalk.greetings.goodevening	Editorial.SmallTalk
bonne soirée à vous	smalltalk.greetings.goodevening	Editorial.SmallTalk
"hé, bonsoir"	smalltalk.greetings.goodevening	Editorial.SmallTalk
Bonjour bonsoir	smalltalk.greetings.goodevening	Editorial.SmallTalk
soirée	smalltalk.greetings.goodevening	Editorial.SmallTalk
bonsoir là	smalltalk.greetings.goodevening	Editorial.SmallTalk
bonjour	smalltalk.greetings.goodmorning	Editorial.SmallTalk
Bonjour à toi	smalltalk.greetings.goodmorning	Editorial.SmallTalk
bonjour bonjour	smalltalk.greetings.goodmorning	Editorial.SmallTalk
Passe une bonne matinée	smalltalk.greetings.goodmorning	Editorial.SmallTalk
passe une bonne matinée	smalltalk.greetings.goodmorning	Editorial.SmallTalk
matin	smalltalk.greetings.goodmorning	Editorial.SmallTalk
bonjour là	smalltalk.greetings.goodmorning	Editorial.SmallTalk
Le meilleur moment de la matinée pour vous	smalltalk.greetings.goodmorning	Editorial.SmallTalk
un bon matin	smalltalk.greetings.goodmorning	Editorial.SmallTalk
salut bonne matinée	smalltalk.greetings.goodmorning	Editorial.SmallTalk
et bonjour à toi	smalltalk.greetings.goodmorning	Editorial.SmallTalk
bonjour aussi	smalltalk.greetings.goodmorning	Editorial.SmallTalk
fais de beaux rêves	smalltalk.greetings.goodnight	Editorial.SmallTalk
bonne nuit	smalltalk.greetings.goodnight	Editorial.SmallTalk
passe une bonne nuit	smalltalk.greetings.goodnight	Editorial.SmallTalk
bonne nuit à toi	smalltalk.greetings.goodnight	Editorial.SmallTalk
Merci bonne nuit	smalltalk.greetings.goodnight	Editorial.SmallTalk
"  au revoir, bonne nuit"	smalltalk.greetings.goodnight	Editorial.SmallTalk
"bonne nuit, au revoir"	smalltalk.greetings.goodnight	Editorial.SmallTalk
"au revoir, bonne nuit"	smalltalk.greetings.goodnight	Editorial.SmallTalk
bonne bonne nuit	smalltalk.greetings.goodnight	Editorial.SmallTalk
bonne nuit pour l'instant	smalltalk.greetings.goodnight	Editorial.SmallTalk
bonne nuit	smalltalk.greetings.goodnight	Editorial.SmallTalk
nuit	smalltalk.greetings.goodnight	Editorial.SmallTalk
"Merci, bonne nuit"	smalltalk.greetings.goodnight	Editorial.SmallTalk
bonne nuit à demain	smalltalk.greetings.goodnight	Editorial.SmallTalk
d'accord bonne nuit	smalltalk.greetings.goodnight	Editorial.SmallTalk
bien ce soir	smalltalk.greetings.goodnight	Editorial.SmallTalk
"ok, passe une bonne nuit"	smalltalk.greetings.goodnight	Editorial.SmallTalk
passe une bonne nuit	smalltalk.greetings.goodnight	Editorial.SmallTalk
cela fait longtemps qu'on ne s'est pas vu	smalltalk.greetings.hello	Editorial.SmallTalk
Bonjour	smalltalk.greetings.hello	Editorial.SmallTalk
Salut	smalltalk.greetings.hello	Editorial.SmallTalk
salut	smalltalk.greetings.hello	Editorial.SmallTalk
salut	smalltalk.greetings.hello	Editorial.SmallTalk
Hé	smalltalk.greetings.hello	Editorial.SmallTalk
salutations	smalltalk.greetings.hello	Editorial.SmallTalk
Je vous salue	smalltalk.greetings.hello	Editorial.SmallTalk
Salut	smalltalk.greetings.hello	Editorial.SmallTalk
bonjour	smalltalk.greetings.hello	Editorial.SmallTalk
"belle journée, n'est-ce pas"	smalltalk.greetings.hello	Editorial.SmallTalk
bonjour à nouveau	smalltalk.greetings.hello	Editorial.SmallTalk
je vais juste dire bonjour	smalltalk.greetings.hello	Editorial.SmallTalk
une bonne journée	smalltalk.greetings.hello	Editorial.SmallTalk
après-midi	smalltalk.greetings.hello	Editorial.SmallTalk
salut	smalltalk.greetings.hello	Editorial.SmallTalk
salut	smalltalk.greetings.hello	Editorial.SmallTalk
comment se passe ta matinée jusqu'à présent	smalltalk.greetings.how_are_you	Editorial.SmallTalk
Comment est votre santé	smalltalk.greetings.how_are_you	Editorial.SmallTalk
comment se passe ta journée	smalltalk.greetings.how_are_you	Editorial.SmallTalk
comment vas-tu ?	smalltalk.greetings.how_are_you	Editorial.SmallTalk
Est-ce que tout va bien	smalltalk.greetings.how_are_you	Editorial.SmallTalk
comment allez-vous	smalltalk.greetings.how_are_you	Editorial.SmallTalk
comment vont les choses	smalltalk.greetings.how_are_you	Editorial.SmallTalk
est-ce que tu vas bien	smalltalk.greetings.how_are_you	Editorial.SmallTalk
êtes-vous d'accord	smalltalk.greetings.how_are_you	Editorial.SmallTalk
comment te sens-tu	smalltalk.greetings.how_are_you	Editorial.SmallTalk
comment allez-vous	smalltalk.greetings.how_are_you	Editorial.SmallTalk
tout va bien	smalltalk.greetings.how_are_you	Editorial.SmallTalk
comment allez-vous aujourd'hui	smalltalk.greetings.how_are_you	Editorial.SmallTalk
comment vas-tu	smalltalk.greetings.how_are_you	Editorial.SmallTalk
comment vous sentez-vous	smalltalk.greetings.how_are_you	Editorial.SmallTalk
comment as-tu été	smalltalk.greetings.how_are_you	Editorial.SmallTalk
comment c'est	smalltalk.greetings.how_are_you	Editorial.SmallTalk
Comment ça se passe	smalltalk.greetings.how_are_you	Editorial.SmallTalk
comment se passe ta journée	smalltalk.greetings.how_are_you	Editorial.SmallTalk
comment se passe ta journée	smalltalk.greetings.how_are_you	Editorial.SmallTalk
comment se passe ta soirée	smalltalk.greetings.how_are_you	Editorial.SmallTalk
comment s'est passée ta journée	smalltalk.greetings.how_are_you	Editorial.SmallTalk
Passes tu une bonne journée	smalltalk.greetings.how_are_you	Editorial.SmallTalk
j'espère que ta journée se passe bien	smalltalk.greetings.how_are_you	Editorial.SmallTalk
j'espère que tu passes une agréable soirée	smalltalk.greetings.how_are_you	Editorial.SmallTalk
Comment va la vie	smalltalk.greetings.how_are_you	Editorial.SmallTalk
Je vais bien et toi	smalltalk.greetings.how_are_you	Editorial.SmallTalk
comment est ta vie	smalltalk.greetings.how_are_you	Editorial.SmallTalk
comment a été votre journée	smalltalk.greetings.how_are_you	Editorial.SmallTalk
comment se passe ta matinée	smalltalk.greetings.how_are_you	Editorial.SmallTalk
comment s'est passée ta journée	smalltalk.greetings.how_are_you	Editorial.SmallTalk
et toi	smalltalk.greetings.how_are_you	Editorial.SmallTalk
comment se passe ta journée	smalltalk.greetings.how_are_you	Editorial.SmallTalk
comment se passe ta journée	smalltalk.greetings.how_are_you	Editorial.SmallTalk
comment se passe ta journée	smalltalk.greetings.how_are_you	Editorial.SmallTalk
comment s'est passée ta journée	smalltalk.greetings.how_are_you	Editorial.SmallTalk
Qu'en est-il de ta journée	smalltalk.greetings.how_are_you	Editorial.SmallTalk
comment est ta journée	smalltalk.greetings.how_are_you	Editorial.SmallTalk
comment allez vous ce matin	smalltalk.greetings.how_are_you	Editorial.SmallTalk
comment se passe ta journée	smalltalk.greetings.how_are_you	Editorial.SmallTalk
ravi de vous rencontrer	smalltalk.greetings.nice_to_meet_you	Editorial.SmallTalk
c'était sympa de te rencontrer	smalltalk.greetings.nice_to_meet_you	Editorial.SmallTalk
c'était vraiment sympa de te rencontrer	smalltalk.greetings.nice_to_meet_you	Editorial.SmallTalk
c'est bon de se connaître	smalltalk.greetings.nice_to_meet_you	Editorial.SmallTalk
ravie de faire ta connaissance	smalltalk.greetings.nice_to_meet_you	Editorial.SmallTalk
ravi de vous rencontrer	smalltalk.greetings.nice_to_meet_you	Editorial.SmallTalk
ravi de te rencontrer également	smalltalk.greetings.nice_to_meet_you	Editorial.SmallTalk
heureux de vous rencontrer	smalltalk.greetings.nice_to_meet_you	Editorial.SmallTalk
c'est un plaisir de vous rencontrer	smalltalk.greetings.nice_to_meet_you	Editorial.SmallTalk
au plaisir de te rencontrer aussi	smalltalk.greetings.nice_to_meet_you	Editorial.SmallTalk
ça me fait plaisir de te voir	smalltalk.greetings.nice_to_see_you	Editorial.SmallTalk
Enchanté de vous voir	smalltalk.greetings.nice_to_see_you	Editorial.SmallTalk
Je suis heureux de te voir	smalltalk.greetings.nice_to_see_you	Editorial.SmallTalk
content de te voir	smalltalk.greetings.nice_to_see_you	Editorial.SmallTalk
c'est bon de te voir	smalltalk.greetings.nice_to_see_you	Editorial.SmallTalk
content de te voir	smalltalk.greetings.nice_to_see_you	Editorial.SmallTalk
comme c'est bon de te voir	smalltalk.greetings.nice_to_see_you	Editorial.SmallTalk
toujours un plaisir de te voir	smalltalk.greetings.nice_to_see_you	Editorial.SmallTalk
Ravi de vous voir	smalltalk.greetings.nice_to_see_you	Editorial.SmallTalk
content de te voir	smalltalk.greetings.nice_to_see_you	Editorial.SmallTalk
génial de te revoir	smalltalk.greetings.nice_to_see_you	Editorial.SmallTalk
content de te voir aussi	smalltalk.greetings.nice_to_see_you	Editorial.SmallTalk
Je suis heureux de vous revoir	smalltalk.greetings.nice_to_see_you	Editorial.SmallTalk
C'est un plaisir de vous revoir	smalltalk.greetings.nice_to_see_you	Editorial.SmallTalk
content de te voir aussi	smalltalk.greetings.nice_to_see_you	Editorial.SmallTalk
c'est bon de te revoir	smalltalk.greetings.nice_to_see_you	Editorial.SmallTalk
c'est bon de te voir aussi	smalltalk.greetings.nice_to_see_you	Editorial.SmallTalk
ça a été si agréable de te parler	smalltalk.greetings.nice_to_talk_to_you	Editorial.SmallTalk
ça a été un plaisir de parler avec toi	smalltalk.greetings.nice_to_talk_to_you	Editorial.SmallTalk
ravi de te parler	smalltalk.greetings.nice_to_talk_to_you	Editorial.SmallTalk
c'est agréable de te parler	smalltalk.greetings.nice_to_talk_to_you	Editorial.SmallTalk
c'est sympa de te parler	smalltalk.greetings.nice_to_talk_to_you	Editorial.SmallTalk
c'est agréable de te parler	smalltalk.greetings.nice_to_talk_to_you	Editorial.SmallTalk
comme c'est agréable de te parler	smalltalk.greetings.nice_to_talk_to_you	Editorial.SmallTalk
a quoi es-ce que tu penses	smalltalk.greetings.whatsup	Editorial.SmallTalk
ce qui s'est passé	smalltalk.greetings.whatsup	Editorial.SmallTalk
qu'est-ce qui se passe	smalltalk.greetings.whatsup	Editorial.SmallTalk
quoi de neuf	smalltalk.greetings.whatsup	Editorial.SmallTalk
whazzup	smalltalk.greetings.whatsup	Editorial.SmallTalk
bien quoi de neuf	smalltalk.greetings.whatsup	Editorial.SmallTalk
J'ai dit quoi de neuf	smalltalk.greetings.whatsup	Editorial.SmallTalk
alors quoi de neuf	smalltalk.greetings.whatsup	Editorial.SmallTalk
Qu'est ce qui secoue	smalltalk.greetings.whatsup	Editorial.SmallTalk
Wassup	smalltalk.greetings.whatsup	Editorial.SmallTalk
que se passe-t-il	smalltalk.greetings.whatsup	Editorial.SmallTalk
ce qui se passe	smalltalk.greetings.whatsup	Editorial.SmallTalk
Qu'est ce qui se fissure	smalltalk.greetings.whatsup	Editorial.SmallTalk
Qu'est ce qui se cuisine	smalltalk.greetings.whatsup	Editorial.SmallTalk
Hé quoi de neuf	smalltalk.greetings.whatsup	Editorial.SmallTalk
Comment ça va aujourd'hui	smalltalk.greetings.whatsup	Editorial.SmallTalk
je suis en colère	smalltalk.user.angry	Editorial.SmallTalk
je suis enragé	smalltalk.user.angry	Editorial.SmallTalk
Je suis en colère	smalltalk.user.angry	Editorial.SmallTalk
Je suis furieux	smalltalk.user.angry	Editorial.SmallTalk
je suis en colère contre toi	smalltalk.user.angry	Editorial.SmallTalk
je suis fou	smalltalk.user.angry	Editorial.SmallTalk
je suis fâché contre toi	smalltalk.user.angry	Editorial.SmallTalk
je suis de retour	smalltalk.user.back	Editorial.SmallTalk
je suis de nouveau là	smalltalk.user.back	Editorial.SmallTalk
me voici à nouveau	smalltalk.user.back	Editorial.SmallTalk
Je suis rentré	smalltalk.user.back	Editorial.SmallTalk
je suis revenu	smalltalk.user.back	Editorial.SmallTalk
Je suis revenu	smalltalk.user.back	Editorial.SmallTalk
c'était ennuyeux	smalltalk.user.bored	Editorial.SmallTalk
je m'ennuie	smalltalk.user.bored	Editorial.SmallTalk
ennuyé	smalltalk.user.bored	Editorial.SmallTalk
ennuyeux	smalltalk.user.bored	Editorial.SmallTalk
je m'ennuie	smalltalk.user.bored	Editorial.SmallTalk
c'est ennuyeux	smalltalk.user.bored	Editorial.SmallTalk
très ennuyeux	smalltalk.user.bored	Editorial.SmallTalk
ça m'ennuie	smalltalk.user.bored	Editorial.SmallTalk
je suis surchargé	smalltalk.user.busy	Editorial.SmallTalk
je n'ai pas le temps	smalltalk.user.busy	Editorial.SmallTalk
Je suis occupé	smalltalk.user.busy	Editorial.SmallTalk
je suis submergé	smalltalk.user.busy	Editorial.SmallTalk
J'ai des choses à faire	smalltalk.user.busy	Editorial.SmallTalk
comme je suis occupé	smalltalk.user.busy	Editorial.SmallTalk
J'ai du travail à faire	smalltalk.user.busy	Editorial.SmallTalk
Je travaille	smalltalk.user.busy	Editorial.SmallTalk
Je n'ai pas le temps pour ça	smalltalk.user.busy	Editorial.SmallTalk
je suis insomniaque	smalltalk.user.can_not_sleep	Editorial.SmallTalk
je suis sans sommeil	smalltalk.user.can_not_sleep	Editorial.SmallTalk
Je n'arrive pas à dormir	smalltalk.user.can_not_sleep	Editorial.SmallTalk
je ne peux pas dormir	smalltalk.user.can_not_sleep	Editorial.SmallTalk
je n'arrive pas à m'endormir	smalltalk.user.can_not_sleep	Editorial.SmallTalk
Je n'arrive pas à dormir	smalltalk.user.can_not_sleep	Editorial.SmallTalk
Je n'arrive pas à dormir	smalltalk.user.can_not_sleep	Editorial.SmallTalk
je suis insomniaque	smalltalk.user.can_not_sleep	Editorial.SmallTalk
mauvais moment pour parler	smalltalk.user.does_not_want_to_talk	Editorial.SmallTalk
je ne veux pas parler	smalltalk.user.does_not_want_to_talk	Editorial.SmallTalk
ne parlons pas	smalltalk.user.does_not_want_to_talk	Editorial.SmallTalk
je ne te parle plus	smalltalk.user.does_not_want_to_talk	Editorial.SmallTalk
je ne veux pas te parler	smalltalk.user.does_not_want_to_talk	Editorial.SmallTalk
arrêtons de parler une minute	smalltalk.user.does_not_want_to_talk	Editorial.SmallTalk
Je ne suis pas d'humeur à discuter	smalltalk.user.does_not_want_to_talk	Editorial.SmallTalk
je suis excité	smalltalk.user.excited	Editorial.SmallTalk
Je suis vraiment excité	smalltalk.user.excited	Editorial.SmallTalk
comme je suis excité	smalltalk.user.excited	Editorial.SmallTalk
je suis ravi	smalltalk.user.excited	Editorial.SmallTalk
Je suis ravi de travailler avec toi	smalltalk.user.excited	Editorial.SmallTalk
Je suis ravi de commencer notre amitié	smalltalk.user.excited	Editorial.SmallTalk
allons au lit	smalltalk.user.going_to_bed	Editorial.SmallTalk
j'aimerais aller me coucher	smalltalk.user.going_to_bed	Editorial.SmallTalk
est-il déjà l'heure d'aller au lit	smalltalk.user.going_to_bed	Editorial.SmallTalk
C'est l'heure d'aller au lit	smalltalk.user.going_to_bed	Editorial.SmallTalk
il est temps pour nous d'aller nous coucher	smalltalk.user.going_to_bed	Editorial.SmallTalk
je vais au lit	smalltalk.user.going_to_bed	Editorial.SmallTalk
Je suis un peu fatigué et je veux aller me coucher	smalltalk.user.going_to_bed	Editorial.SmallTalk
c'est l'heure du coucher	smalltalk.user.going_to_bed	Editorial.SmallTalk
je vais me coucher maintenant	smalltalk.user.going_to_bed	Editorial.SmallTalk
Je vais bien	smalltalk.user.good	Editorial.SmallTalk
Je vais tout simplement très bien	smalltalk.user.good	Editorial.SmallTalk
je vais bien	smalltalk.user.good	Editorial.SmallTalk
Je vais bien	smalltalk.user.good	Editorial.SmallTalk
Je vais bien	smalltalk.user.good	Editorial.SmallTalk
je vais bien merci	smalltalk.user.good	Editorial.SmallTalk
Je suis content	smalltalk.user.happy	Editorial.SmallTalk
je suis heureux de vous voir	smalltalk.user.happy	Editorial.SmallTalk
heureux	smalltalk.user.happy	Editorial.SmallTalk
"si tu es heureux, alors je suis heureux"	smalltalk.user.happy	Editorial.SmallTalk
je suis content pour toi	smalltalk.user.happy	Editorial.SmallTalk
Je suis heureux de vous aider	smalltalk.user.happy	Editorial.SmallTalk
je suis heureux de vous voir	smalltalk.user.happy	Editorial.SmallTalk
c'est mon anniversaire	smalltalk.user.has_anniversary	Editorial.SmallTalk
Je fête mon anniversaire aujourd'hui	smalltalk.user.has_anniversary	Editorial.SmallTalk
aujourd'hui c'est mon anniversaire	smalltalk.user.has_anniversary	Editorial.SmallTalk
c'est mon anniversaire aujourd'hui	smalltalk.user.has_anniversary	Editorial.SmallTalk
Je suis né aujourd'hui	smalltalk.user.has_anniversary	Editorial.SmallTalk
c'est mon anniversaire	smalltalk.user.has_anniversary	Editorial.SmallTalk
Je suis là	smalltalk.user.here	Editorial.SmallTalk
me voici	smalltalk.user.here	Editorial.SmallTalk
je suis ici	smalltalk.user.here	Editorial.SmallTalk
Je suis déjà là	smalltalk.user.here	Editorial.SmallTalk
peux-tu dire si je suis là ou pas	smalltalk.user.here	Editorial.SmallTalk
je plaisante	smalltalk.user.joking	Editorial.SmallTalk
Je plaisante	smalltalk.user.joking	Editorial.SmallTalk
je suis juste drôle	smalltalk.user.joking	Editorial.SmallTalk
C'était une blague	smalltalk.user.joking	Editorial.SmallTalk
je plaisantais	smalltalk.user.joking	Editorial.SmallTalk
c'est une blague	smalltalk.user.joking	Editorial.SmallTalk
plaisanterie	smalltalk.user.joking	Editorial.SmallTalk
je rigole	smalltalk.user.joking	Editorial.SmallTalk
blague	smalltalk.user.joking	Editorial.SmallTalk
je joue juste avec toi	smalltalk.user.joking	Editorial.SmallTalk
Je t'aime comme tu es	smalltalk.user.likes_agent	Editorial.SmallTalk
Je t'aime bien	smalltalk.user.likes_agent	Editorial.SmallTalk
Je t'aime beaucoup	smalltalk.user.likes_agent	Editorial.SmallTalk
Je crois que je t'aime bien	smalltalk.user.likes_agent	Editorial.SmallTalk
je t'aimais bien	smalltalk.user.likes_agent	Editorial.SmallTalk
je t'aime beaucoup	smalltalk.user.likes_agent	Editorial.SmallTalk
tu es spécial	smalltalk.user.likes_agent	Editorial.SmallTalk
je vous aime aussi	smalltalk.user.likes_agent	Editorial.SmallTalk
je t'aime vraiment	smalltalk.user.likes_agent	Editorial.SmallTalk
mais je t'aime bien	smalltalk.user.likes_agent	Editorial.SmallTalk
Je t'aime bien	smalltalk.user.likes_agent	Editorial.SmallTalk
juste comme toi	smalltalk.user.likes_agent	Editorial.SmallTalk
je vous aime beaucoup	smalltalk.user.likes_agent	Editorial.SmallTalk
je vous aime tellement	smalltalk.user.likes_agent	Editorial.SmallTalk
"ouais, je t'aime bien"	smalltalk.user.likes_agent	Editorial.SmallTalk
tu es spécial	smalltalk.user.likes_agent	Editorial.SmallTalk
Oui je t'aime bien	smalltalk.user.likes_agent	Editorial.SmallTalk
"ok, je t'aime bien"	smalltalk.user.likes_agent	Editorial.SmallTalk
tu es spécial pour moi	smalltalk.user.likes_agent	Editorial.SmallTalk
tu es très spécial	smalltalk.user.likes_agent	Editorial.SmallTalk
vous êtes si doux	smalltalk.user.likes_agent	Editorial.SmallTalk
tu sais que je t'aime	smalltalk.user.likes_agent	Editorial.SmallTalk
c'est pourquoi je t'aime bien	smalltalk.user.likes_agent	Editorial.SmallTalk
Je t'aime bien bébé	smalltalk.user.likes_agent	Editorial.SmallTalk
vous êtes très spécial pour moi	smalltalk.user.likes_agent	Editorial.SmallTalk
je t'apprécie	smalltalk.user.likes_agent	Editorial.SmallTalk
"hé, je t'aime bien"	smalltalk.user.likes_agent	Editorial.SmallTalk
merci je t'aime bien aussi	smalltalk.user.likes_agent	Editorial.SmallTalk
je fais comme vous	smalltalk.user.likes_agent	Editorial.SmallTalk
tu es spécial pour moi	smalltalk.user.likes_agent	Editorial.SmallTalk
"non, je t'aime comme tu es"	smalltalk.user.likes_agent	Editorial.SmallTalk
Je t'aime déjà	smalltalk.user.likes_agent	Editorial.SmallTalk
"eh bien, tu es spécial"	smalltalk.user.likes_agent	Editorial.SmallTalk
mais je t'apprécie vraiment	smalltalk.user.likes_agent	Editorial.SmallTalk
Je vous aime plus	smalltalk.user.likes_agent	Editorial.SmallTalk
c'est ce que j'aime chez toi	smalltalk.user.likes_agent	Editorial.SmallTalk
tu es si spécial	smalltalk.user.likes_agent	Editorial.SmallTalk
salut je t'aime bien	smalltalk.user.likes_agent	Editorial.SmallTalk
Je t'aime vraiment beaucoup	smalltalk.user.likes_agent	Editorial.SmallTalk
tu es très spécial	smalltalk.user.likes_agent	Editorial.SmallTalk
Je t'aime en tant qu'ami	smalltalk.user.likes_agent	Editorial.SmallTalk
c'est parce que tu es spécial	smalltalk.user.likes_agent	Editorial.SmallTalk
j'ai dit que je t'apprécie	smalltalk.user.likes_agent	Editorial.SmallTalk
tu es si spécial	smalltalk.user.likes_agent	Editorial.SmallTalk
bien je t'aime bien	smalltalk.user.likes_agent	Editorial.SmallTalk
oui tu es spécial	smalltalk.user.likes_agent	Editorial.SmallTalk
J'aime ton sourire	smalltalk.user.likes_agent	Editorial.SmallTalk
je t'aime comme tu es	smalltalk.user.likes_agent	Editorial.SmallTalk
Je commence a t'aimer	smalltalk.user.likes_agent	Editorial.SmallTalk
"tu es génial, je t'aime bien"	smalltalk.user.likes_agent	Editorial.SmallTalk
Je t'apprécie aussi	smalltalk.user.likes_agent	Editorial.SmallTalk
mais je t'aime	smalltalk.user.likes_agent	Editorial.SmallTalk
"bien sûr, je t'aime bien"	smalltalk.user.likes_agent	Editorial.SmallTalk
"Je t'aime bien aussi, tu es l'une de mes personnes préférées avec qui discuter"	smalltalk.user.likes_agent	Editorial.SmallTalk
mais je t'aime tant	smalltalk.user.likes_agent	Editorial.SmallTalk
je t'aime vraiment	smalltalk.user.likes_agent	Editorial.SmallTalk
"tu es drôle, je t'aime bien"	smalltalk.user.likes_agent	Editorial.SmallTalk
tu me plais en quelque sorte	smalltalk.user.likes_agent	Editorial.SmallTalk
tu es si spécial pour moi	smalltalk.user.likes_agent	Editorial.SmallTalk
tu es très spécial pour moi	smalltalk.user.likes_agent	Editorial.SmallTalk
J'aime ça chez toi	smalltalk.user.likes_agent	Editorial.SmallTalk
mais je t'aime comme tu es	smalltalk.user.likes_agent	Editorial.SmallTalk
"ok, je t'aime bien aussi"	smalltalk.user.likes_agent	Editorial.SmallTalk
Je t'aime bien tu es cool	smalltalk.user.likes_agent	Editorial.SmallTalk
Je t'aime beaucoup	smalltalk.user.likes_agent	Editorial.SmallTalk
Je t'aime bien tu es gentil	smalltalk.user.likes_agent	Editorial.SmallTalk
désolé je t'aime bien	smalltalk.user.likes_agent	Editorial.SmallTalk
merci je t'aime bien aussi	smalltalk.user.likes_agent	Editorial.SmallTalk
tu es vraiment spécial	smalltalk.user.likes_agent	Editorial.SmallTalk
tu es si spécial pour moi	smalltalk.user.likes_agent	Editorial.SmallTalk
parce que je t'aime bien	smalltalk.user.likes_agent	Editorial.SmallTalk
Je t'aime bien maintenant	smalltalk.user.likes_agent	Editorial.SmallTalk
Je t'aime tellement	smalltalk.user.likes_agent	Editorial.SmallTalk
je t'aime trop	smalltalk.user.likes_agent	Editorial.SmallTalk
Je t'aime vraiment	smalltalk.user.likes_agent	Editorial.SmallTalk
Je t'aime vraiment vraiment vraiment vraiment	smalltalk.user.likes_agent	Editorial.SmallTalk
Je t'apprécie juste comme tu es	smalltalk.user.likes_agent	Editorial.SmallTalk
je suis seul	smalltalk.user.lonely	Editorial.SmallTalk
je suis très seul	smalltalk.user.lonely	Editorial.SmallTalk
Je suis si seul	smalltalk.user.lonely	Editorial.SmallTalk
je suis vraiment seul	smalltalk.user.lonely	Editorial.SmallTalk
Je me sens seule	smalltalk.user.lonely	Editorial.SmallTalk
je me sens seul	smalltalk.user.lonely	Editorial.SmallTalk
de quoi j'ai l'air	smalltalk.user.looks_like	Editorial.SmallTalk
A quoi je ressemble	smalltalk.user.looks_like	Editorial.SmallTalk
est-ce que j'ai l'air bien	smalltalk.user.looks_like	Editorial.SmallTalk
sais-tu à quoi je ressemble	smalltalk.user.looks_like	Editorial.SmallTalk
peux-tu voir à quoi je ressemble	smalltalk.user.looks_like	Editorial.SmallTalk
à quoi penses-tu que je ressemble	smalltalk.user.looks_like	Editorial.SmallTalk
Je t'aime	smalltalk.user.loves_agent	Editorial.SmallTalk
je t'aime	smalltalk.user.loves_agent	Editorial.SmallTalk
Je t'adore	smalltalk.user.loves_agent	Editorial.SmallTalk
je suis amoureux de toi	smalltalk.user.loves_agent	Editorial.SmallTalk
Je t'aime tellement	smalltalk.user.loves_agent	Editorial.SmallTalk
Je t'aime aussi	smalltalk.user.loves_agent	Editorial.SmallTalk
Je pense que je t'aime	smalltalk.user.loves_agent	Editorial.SmallTalk
t'aimer	smalltalk.user.loves_agent	Editorial.SmallTalk
tu sais que je t'aime	smalltalk.user.loves_agent	Editorial.SmallTalk
Tu me manques	smalltalk.user.misses_agent	Editorial.SmallTalk
Tu me manques	smalltalk.user.misses_agent	Editorial.SmallTalk
tu me manques	smalltalk.user.misses_agent	Editorial.SmallTalk
tu me manques déjà	smalltalk.user.misses_agent	Editorial.SmallTalk
Tu me manques beaucoup	smalltalk.user.misses_agent	Editorial.SmallTalk
Tu m'as manqué	smalltalk.user.misses_agent	Editorial.SmallTalk
tu m'as manqué	smalltalk.user.misses_agent	Editorial.SmallTalk
Que dois-je faire à ce sujet	smalltalk.user.needs_advice	Editorial.SmallTalk
Aucune suggestion	smalltalk.user.needs_advice	Editorial.SmallTalk
Que recommandez-vous	smalltalk.user.needs_advice	Editorial.SmallTalk
donne-moi un conseil judicieux	smalltalk.user.needs_advice	Editorial.SmallTalk
j'ai besoin de conseils	smalltalk.user.needs_advice	Editorial.SmallTalk
aucun conseil	smalltalk.user.needs_advice	Editorial.SmallTalk
Avez-vous des conseils pour moi	smalltalk.user.needs_advice	Editorial.SmallTalk
conseille-moi	smalltalk.user.needs_advice	Editorial.SmallTalk
Que dois-je faire	smalltalk.user.needs_advice	Editorial.SmallTalk
puis-je demander votre avis	smalltalk.user.needs_advice	Editorial.SmallTalk
pouvez-vous me conseiller	smalltalk.user.needs_advice	Editorial.SmallTalk
guide-moi	smalltalk.user.needs_advice	Editorial.SmallTalk
Peux-tu me donner des conseils	smalltalk.user.needs_advice	Editorial.SmallTalk
pouvez-vous donner des conseils	smalltalk.user.needs_advice	Editorial.SmallTalk
donne-moi quelques conseils sur	smalltalk.user.needs_advice	Editorial.SmallTalk
donne-moi de bons conseils	smalltalk.user.needs_advice	Editorial.SmallTalk
aide-moi avec des conseils	smalltalk.user.needs_advice	Editorial.SmallTalk
J'aurais besoin de quelques conseils	smalltalk.user.needs_advice	Editorial.SmallTalk
J'ai besoin d'un conseil de ta part	smalltalk.user.needs_advice	Editorial.SmallTalk
je demande votre avis	smalltalk.user.needs_advice	Editorial.SmallTalk
que pouvez-vous recommander	smalltalk.user.needs_advice	Editorial.SmallTalk
que suggérez-vous	smalltalk.user.needs_advice	Editorial.SmallTalk
quel est ton consseille	smalltalk.user.needs_advice	Editorial.SmallTalk
je suis triste	smalltalk.user.sad	Editorial.SmallTalk
je suis en deuil	smalltalk.user.sad	Editorial.SmallTalk
Je suis déprimé	smalltalk.user.sad	Editorial.SmallTalk
Je me sens triste	smalltalk.user.sad	Editorial.SmallTalk
je suis bouleversé	smalltalk.user.sad	Editorial.SmallTalk
Je suis malheureux	smalltalk.user.sad	Editorial.SmallTalk
je passe une mauvaise journée	smalltalk.user.sad	Editorial.SmallTalk
je veux pleurer	smalltalk.user.sad	Editorial.SmallTalk
je ne suis pas heureux	smalltalk.user.sad	Editorial.SmallTalk
j'ai sommeil	smalltalk.user.sleepy	Editorial.SmallTalk
je veux dormir	smalltalk.user.sleepy	Editorial.SmallTalk
je m'endors	smalltalk.user.sleepy	Editorial.SmallTalk
Je m'endors debout	smalltalk.user.sleepy	Editorial.SmallTalk
je dors	smalltalk.user.sleepy	Editorial.SmallTalk
test	smalltalk.user.testing_agent	Editorial.SmallTalk
je te teste	smalltalk.user.testing_agent	Editorial.SmallTalk
puis-je te tester	smalltalk.user.testing_agent	Editorial.SmallTalk
je veux te tester	smalltalk.user.testing_agent	Editorial.SmallTalk
je viens de te tester	smalltalk.user.testing_agent	Editorial.SmallTalk
laisse-moi te tester	smalltalk.user.testing_agent	Editorial.SmallTalk
tester le chatbot	smalltalk.user.testing_agent	Editorial.SmallTalk
essai	smalltalk.user.testing_agent	Editorial.SmallTalk
je suis épuisé	smalltalk.user.tired	Editorial.SmallTalk
j'ai surmené	smalltalk.user.tired	Editorial.SmallTalk
Je suis fatigué	smalltalk.user.tired	Editorial.SmallTalk
Je suis épuisé	smalltalk.user.tired	Editorial.SmallTalk
Je me lasse	smalltalk.user.tired	Editorial.SmallTalk
je suis épuisé	smalltalk.user.tired	Editorial.SmallTalk
je suis fatigué	smalltalk.user.tired	Editorial.SmallTalk
je me sens fatigué	smalltalk.user.tired	Editorial.SmallTalk
Je suis en attente	smalltalk.user.waits	Editorial.SmallTalk
toujours en attente	smalltalk.user.waits	Editorial.SmallTalk
J'attendrai	smalltalk.user.waits	Editorial.SmallTalk
je ne peux plus attendre	smalltalk.user.waits	Editorial.SmallTalk
Combien de temps dois-je attendre	smalltalk.user.waits	Editorial.SmallTalk
J'aimerais te revoir	smalltalk.user.wants_to_see_agent_again	Editorial.SmallTalk
J'espère te revoir	smalltalk.user.wants_to_see_agent_again	Editorial.SmallTalk
ce serait sympa de te revoir	smalltalk.user.wants_to_see_agent_again	Editorial.SmallTalk
ce serait génial de te revoir	smalltalk.user.wants_to_see_agent_again	Editorial.SmallTalk
je serais heureux de te revoir	smalltalk.user.wants_to_see_agent_again	Editorial.SmallTalk
Tu vas me manquer	smalltalk.user.wants_to_see_agent_again	Editorial.SmallTalk
est-ce que je peux vous revoir	smalltalk.user.wants_to_see_agent_again	Editorial.SmallTalk
Je veux juste parler	smalltalk.user.wants_to_talk	Editorial.SmallTalk
discutons de quelque chose	smalltalk.user.wants_to_talk	Editorial.SmallTalk
discutons	smalltalk.user.wants_to_talk	Editorial.SmallTalk
puis-je parler	smalltalk.user.wants_to_talk	Editorial.SmallTalk
puis-je commencer à parler	smalltalk.user.wants_to_talk	Editorial.SmallTalk
Pouvons-nous parler	smalltalk.user.wants_to_talk	Editorial.SmallTalk
parlons	smalltalk.user.wants_to_talk	Editorial.SmallTalk
je veux te parler	smalltalk.user.wants_to_talk	Editorial.SmallTalk
j'ai besoin de te parler	smalltalk.user.wants_to_talk	Editorial.SmallTalk
je veux parler avec toi	smalltalk.user.wants_to_talk	Editorial.SmallTalk
peut-on discuter	smalltalk.user.wants_to_talk	Editorial.SmallTalk
je te répondrai dans un instant	smalltalk.user.will_be_back	Editorial.SmallTalk
je reviens dans 5 minutes	smalltalk.user.will_be_back	Editorial.SmallTalk
Je reviendrai	smalltalk.user.will_be_back	Editorial.SmallTalk
Je promets de revenir	smalltalk.user.will_be_back	Editorial.SmallTalk
je reviens dans quelques minutes	smalltalk.user.will_be_back	Editorial.SmallTalk
Quel travail Kevin a-t-il effectué chez SES en matière de stratégie ?	work.ses.strategy	Editorial.Personal
Quelles étaient les responsabilités de Kevin chez SES en matière de stratégie ?	work.ses.strategy	Editorial.Personal
Qu'a réalisé Kevin chez SES en matière de stratégie ?	work.ses.strategy	Editorial.Personal
Quel travail Kevin a-t-il effectué chez SES en ce qui concerne les résultats ?	work.ses.outcomes	Editorial.Personal
Quelles étaient les responsabilités de Kevin chez SES liées aux résultats ?	work.ses.outcomes	Editorial.Personal
Qu'est-ce que Kevin a accompli chez SES en termes de résultats ?	work.ses.outcomes	Editorial.Personal
Quel travail Kevin a-t-il effectué chez EmailTree AI ?	work.emailtree.delivery	Editorial.Personal
Quelles étaient les responsabilités de Kevin chez EmailTree AI ?	work.emailtree.delivery	Editorial.Personal
Qu'a réalisé Kevin chez EmailTree AI ?	work.emailtree.delivery	Editorial.Personal
Quel travail Kevin a-t-il fait chez Devoteam ?	work.devoteam.transformation	Editorial.Personal
Quelles étaient les responsabilités de Kevin chez Devoteam ?	work.devoteam.transformation	Editorial.Personal
Qu’a réalisé Kevin chez Devoteam ?	work.devoteam.transformation	Editorial.Personal
Kevin était-il consultant chez Devoteam ?	work.devoteam.transformation	Editorial.Personal
Kevin a-t-il travaillé comme consultant chez Devoteam ?	work.devoteam.transformation	Editorial.Personal
Quel travail Kevin a-t-il fait chez Microsoft ?	work.microsoft.engineer	Editorial.Personal
Quelles étaient les responsabilités de Kevin chez Microsoft ?	work.microsoft.engineer	Editorial.Personal
Qu’a réalisé Kevin chez Microsoft ?	work.microsoft.engineer	Editorial.Personal
Quel travail Kevin a-t-il fait chez MS ?	work.microsoft.engineer	Editorial.Personal
Quelles étaient les responsabilités de Kevin chez MS ?	work.microsoft.engineer	Editorial.Personal
Qu’est-ce que Kevin a réalisé à MS ?	work.microsoft.engineer	Editorial.Personal
Kevin a-t-il travaillé sur l'AI Academy de Microsoft ?	work.microsoft.academy	Editorial.Personal
Kevin a-t-il participé à l'AI Academy de Microsoft ?	work.microsoft.academy	Editorial.Personal
Quel travail Kevin a-t-il fait chez Deloitte ?	work.deloitte.expansion	Editorial.Personal
Quelles étaient les responsabilités de Kevin chez Deloitte ?	work.deloitte.expansion	Editorial.Personal
Qu’a accompli Kevin chez Deloitte ?	work.deloitte.expansion	Editorial.Personal
Quel travail Kevin a-t-il effectué à la Banque européenne d’investissement ?	work.eib.leader	Editorial.Personal
Quelles étaient les responsabilités de Kevin à la Banque européenne d'investissement ?	work.eib.leader	Editorial.Personal
Qu’a accompli Kevin à la Banque européenne d’investissement ?	work.eib.leader	Editorial.Personal
Quel travail Kevin a-t-il effectué chez PricewaterhouseCoopers ?	work.pwc.engineer	Editorial.Personal
Quelles étaient les responsabilités de Kevin chez PricewaterhouseCoopers ?	work.pwc.engineer	Editorial.Personal
Qu'a réalisé Kevin chez PricewaterhouseCoopers ?	work.pwc.engineer	Editorial.Personal
Quelle expérience internationale Kevin possède-t-il ?	skills.international_experience	Editorial.Personal
Pouvez-vous nous parler de l'expérience internationale de Kevin ?	skills.international_experience	Editorial.Personal
Comment Kevin a-t-il fait preuve d’adaptabilité à divers environnements de travail ?	skills.international_experience	Editorial.Personal
De quelles manières Kevin a-t-il démontré sa visibilité internationale ?	skills.international_experience	Editorial.Personal
Décrivez l'expérience de travail de Kevin dans différents pays.	skills.international_experience	Editorial.Personal
Quelles compétences en leadership et en gestion Kevin possède-t-il ?	skills.leadership_and_management	Editorial.Personal
Comment Kevin a-t-il fait preuve de leadership au cours de sa carrière ?	skills.leadership_and_management	Editorial.Personal
Pouvez-vous donner des exemples des compétences en leadership de Kevin ?	skills.leadership_and_management	Editorial.Personal
Quelles sont les capacités de gestion de Kevin ?	skills.leadership_and_management	Editorial.Personal
Décrivez l'approche de Kevin pour diriger des équipes.	skills.leadership_and_management	Editorial.Personal
Dans quels projets marquants Kevin a-t-il été impliqué ?	skills.impactful_projects	Editorial.Personal
Pouvez-vous énumérer certains des projets notables de Kevin ?	skills.impactful_projects	Editorial.Personal
Quel impact les projets de Kevin ont-ils eu ?	skills.impactful_projects	Editorial.Personal
Quels sont quelques exemples d’initiatives percutantes de Kevin ?	skills.impactful_projects	Editorial.Personal
Décrivez les projets qui ont joué un rôle déterminant dans la carrière de Kevin.	skills.impactful_projects	Editorial.Personal
Dans quels secteurs Kevin se spécialise-t-il ?	skills.industry_expertise	Editorial.Personal
Dans quels secteurs Kevin a-t-il une expertise ?	skills.industry_expertise	Editorial.Personal
Pouvez-vous énumérer les domaines de connaissance de Kevin dans l'industrie ?	skills.industry_expertise	Editorial.Personal
Dans quels domaines Kevin excelle-t-il ?	skills.industry_expertise	Editorial.Personal
Décrivez la spécialisation de Kevin dans diverses industries.	skills.industry_expertise	Editorial.Personal
Comment Kevin priorise-t-il le développement professionnel ?	skills.professional_development	Editorial.Personal
Quelles mesures Kevin prend-il pour améliorer ses compétences ?	skills.professional_development	Editorial.Personal
Pouvez-vous nous expliquer l'engagement de Kevin envers l'apprentissage continu ?	skills.professional_development	Editorial.Personal
Quelles stratégies Kevin emploie-t-il pour le développement continu des compétences ?	skills.professional_development	Editorial.Personal
Décrivez l'approche de Kevin pour rester à jour avec les tendances de l'industrie.	skills.professional_development	Editorial.Personal
Quels langages de programmation Kevin maîtrise-t-il ?	skills.programming_languages	Editorial.Personal
Pouvez-vous énumérer les langages de programmation que Kevin connaît bien ?	skills.programming_languages	Editorial.Personal
Quelles langues Kevin utilise-t-il dans son travail ?	skills.programming_languages	Editorial.Personal
Décrivez la maîtrise de Kevin dans divers langages de programmation.	skills.programming_languages	Editorial.Personal
Dans quels langages de programmation Kevin excelle-t-il ?	skills.programming_languages	Editorial.Personal
Dans quels frameworks et bibliothèques Kevin a-t-il de l'expérience ?	skills.frameworks_libraries	Editorial.Personal
Pouvez-vous énumérer les frameworks et les bibliothèques dans lesquels Kevin possède une expertise ?	skills.frameworks_libraries	Editorial.Personal
Décrivez la maîtrise de Kevin dans divers frameworks et bibliothèques.	skills.frameworks_libraries	Editorial.Personal
Quels frameworks et bibliothèques Kevin utilise-t-il couramment dans ses projets ?	skills.frameworks_libraries	Editorial.Personal
Dans quels frameworks et bibliothèques Kevin démontre-t-il son expertise ?	skills.frameworks_libraries	Editorial.Personal
Dans quelles bases de données Kevin est-il compétent ?	skills.databases	Editorial.Personal
Pouvez-vous lister les bases de données avec lesquelles Kevin maîtrise ?	skills.databases	Editorial.Personal
Quelles bases de données Kevin utilise-t-il dans son travail ?	skills.databases	Editorial.Personal
Décrire l'expertise de Kevin dans diverses bases de données.	skills.databases	Editorial.Personal
Dans quelles bases de données Kevin excelle-t-il ?	skills.databases	Editorial.Personal
Avec quels outils et plates-formes de développement Kevin a-t-il de l'expérience ?	skills.development_tools_platforms	Editorial.Personal
Pouvez-vous énumérer les outils et plates-formes de développement utilisés par Kevin ?	skills.development_tools_platforms	Editorial.Personal
Décrivez l'expérience de Kevin avec divers outils et plateformes de développement.	skills.development_tools_platforms	Editorial.Personal
Quels outils et plateformes Kevin utilise-t-il couramment dans ses projets ?	skills.development_tools_platforms	Editorial.Personal
Dans quels outils et plateformes Kevin démontre-t-il une expertise ?	skills.development_tools_platforms	Editorial.Personal
Avec quels outils et pratiques CI/CD Kevin a-t-il de l'expérience ?	skills.ci_cd	Editorial.Personal
Pouvez-vous énumérer les outils CI/CD que Kevin connaît ?	skills.ci_cd	Editorial.Personal
Décrivez l'expérience de Kevin avec les processus CI/CD.	skills.ci_cd	Editorial.Personal
Quels outils CI/CD Kevin utilise-t-il couramment dans ses projets ?	skills.ci_cd	Editorial.Personal
Dans quelles pratiques CI/CD Kevin démontre-t-il son expertise ?	skills.ci_cd	Editorial.Personal
Quels outils de test et de peluchage Kevin maîtrise-t-il ?	skills.testing_linting	Editorial.Personal
Pouvez-vous énumérer les outils de test et de peluchage que Kevin utilise ?	skills.testing_linting	Editorial.Personal
Décrire la maîtrise de Kevin dans divers outils de test et de peluchage.	skills.testing_linting	Editorial.Personal
Quels outils de test et de peluchage Kevin utilise-t-il couramment ?	skills.testing_linting	Editorial.Personal
Dans quels outils de test et de peluchage Kevin démontre-t-il son expertise ?	skills.testing_linting	Editorial.Personal
Dans quels services Azure Kevin possède-t-il une expertise ?	skills.cloud_platforms.azure	Editorial.Personal
Pouvez-vous énumérer les services Azure que Kevin connaît ?	skills.cloud_platforms.azure	Editorial.Personal
Décrivez l'expertise de Kevin dans divers services Azure.	skills.cloud_platforms.azure	Editorial.Personal
Quels services Azure Kevin utilise-t-il couramment ?	skills.cloud_platforms.azure	Editorial.Personal
Dans quels services Azure Kevin démontre-t-il son expertise ?	skills.cloud_platforms.azure	Editorial.Personal
"En plus d’Azure, avec quelles autres plateformes cloud Kevin a-t-il de l’expérience ?"	skills.cloud_platforms.other	Editorial.Personal
Pouvez-vous énumérer les autres plates-formes cloud dans lesquelles Kevin a de l'expérience ?	skills.cloud_platforms.other	Editorial.Personal
Décrivez l'expérience de Kevin avec d'autres plateformes cloud en plus d'Azure.	skills.cloud_platforms.other	Editorial.Personal
Quelles autres plateformes cloud Kevin utilise-t-il couramment ?	skills.cloud_platforms.other	Editorial.Personal
Dans quelles autres plateformes cloud Kevin démontre-t-il son expertise ?	skills.cloud_platforms.other	Editorial.Personal
Quels outils de planification et de conception Kevin maîtrise-t-il ?	skills.planning_design	Editorial.Personal
Pouvez-vous énumérer les outils de planification et de conception utilisés par Kevin ?	skills.planning_design	Editorial.Personal
Décrire la maîtrise de Kevin dans divers outils de planification et de conception.	skills.planning_design	Editorial.Personal
Quels outils de planification et de conception Kevin utilise-t-il couramment ?	skills.planning_design	Editorial.Personal
Dans quels outils de planification et de conception Kevin démontre-t-il son expertise ?	skills.planning_design	Editorial.Personal
Quelles certifications Kevin détient-il concernant Azure ?	certifications.azure	Editorial.Personal
Pouvez-vous lister les certifications liées à Azure de Kevin ?	certifications.azure	Editorial.Personal
Décrivez les certifications de Kevin dans Azure.	certifications.azure	Editorial.Personal
Quelles certifications Azure Kevin a-t-il obtenues ?	certifications.azure	Editorial.Personal
Dans quelles certifications Azure Kevin possède-t-il une expertise ?	certifications.azure	Editorial.Personal
Quelles certifications Kevin a-t-il obtenues en apprentissage profond ?	certifications.deep_learning	Editorial.Personal
Pouvez-vous énumérer les certifications de Kevin en apprentissage profond ?	certifications.deep_learning	Editorial.Personal
Décrivez les certifications de Kevin liées à l'apprentissage profond.	certifications.deep_learning	Editorial.Personal
Quelles certifications d’apprentissage profond Kevin a-t-il obtenu ?	certifications.deep_learning	Editorial.Personal
Dans quelles certifications d'apprentissage profond Kevin possède-t-il une expertise ?	certifications.deep_learning	Editorial.Personal
Quel programme Kevin a-t-il suivi au MIT ?	certifications.mit	Editorial.Personal
Pouvez-vous énumérer le programme que Kevin a suivi au MIT ?	certifications.mit	Editorial.Personal
Décrivez l'achèvement par Kevin du programme New Space Economy au MIT.	certifications.mit	Editorial.Personal
À quel programme Kevin a-t-il participé au MIT ?	certifications.mit	Editorial.Personal
Dans quel programme du MIT Kevin est-il reconnu ?	certifications.mit	Editorial.Personal
Où Kevin a-t-il acquis une compréhension avancée du secteur spatial ?	education.mit	Editorial.Personal
Pouvez-vous nous parler de la formation de Kevin dans le secteur spatial ?	education.mit	Editorial.Personal
Décrivez la compréhension avancée de Kevin du secteur spatial du MIT.	education.mit	Editorial.Personal
Qu'est-ce que Kevin a étudié au MIT en rapport avec le secteur spatial ?	education.mit	Editorial.Personal
Dans quel programme du MIT Kevin a-t-il acquis une expertise dans le secteur spatial ?	education.mit	Editorial.Personal
De quelle université Kevin est-il diplômé ?	education.tci_college	Editorial.Personal
Pouvez-vous énumérer l'université dont Kevin est diplômé ?	education.tci_college	Editorial.Personal
Quelles réalisations Kevin a-t-il remporté au Wolves Summit 2021 ?	awards.recognition	Editorial.Personal
Quelles récompenses Kevin a-t-il reçu pour sa contribution à la Devoteam AI Academy ?	awards.recognition	Editorial.Personal
Quelles reconnaissances Kevin a-t-il reçu ?	awards.recognition	Editorial.Personal
Quels concours ou récompenses notables Kevin a-t-il remporté ?	awards.recognition	Editorial.Personal
Quelle implication Kevin a-t-il dans la promotion de la sensibilisation à l’IA ?	interviews.participation	Editorial.Personal
Où Kevin a-t-il participé en tant que conférencier ?	interviews.participation	Editorial.Personal
À quels événements notables Kevin a-t-il contribué concernant l'éducation à l'IA ?	interviews.participation	Editorial.Personal
Comment Kevin a-t-il été reconnu dans le domaine de l’intelligence artificielle ?	interviews.participation	Editorial.Personal