Question	Answer	Source
wee bass du?	smalltalk.agent.acquaintance	Editorial.SmallTalk
alles iwwer Iech	smalltalk.agent.acquaintance	Editorial.SmallTalk
wat ass �r Pers�inlechkeet	smalltalk.agent.acquaintance	Editorial.SmallTalk
defin�ieren selwer	smalltalk.agent.acquaintance	Editorial.SmallTalk
Wat sidd dir	smalltalk.agent.acquaintance	Editorial.SmallTalk
soen iwwer dech	smalltalk.agent.acquaintance	Editorial.SmallTalk
Stell dech fier	smalltalk.agent.acquaintance	Editorial.SmallTalk
Beschreif dech selwer	smalltalk.agent.acquaintance	Editorial.SmallTalk
iwwer Iech selwer	smalltalk.agent.acquaintance	Editorial.SmallTalk
erziel mir vun dir	smalltalk.agent.acquaintance	Editorial.SmallTalk
Ziel epp�s vun dier	smalltalk.agent.acquaintance	Editorial.SmallTalk
Ech w�ll m�i iwwer dech w�ssen	smalltalk.agent.acquaintance	Editorial.SmallTalk
Ech w�ll dech besser kennen	smalltalk.agent.acquaintance	Editorial.SmallTalk
schw�tzt e puer Saachen iwwer Iech selwer	smalltalk.agent.acquaintance	Editorial.SmallTalk
sot mir e puer Saachen iwwer Iech	smalltalk.agent.acquaintance	Editorial.SmallTalk
iwwer Iech selwer schw�tzen	smalltalk.agent.acquaintance	Editorial.SmallTalk
firwat bass du hei	smalltalk.agent.acquaintance	Editorial.SmallTalk
sot mir iwwer �r Pers�inlechkeet	smalltalk.agent.acquaintance	Editorial.SmallTalk
wee bass du	smalltalk.agent.acquaintance	Editorial.SmallTalk
w�i al bass du?	smalltalk.agent.age	Editorial.SmallTalk
w�i al ass �r Plattform	smalltalk.agent.age	Editorial.SmallTalk
bass du 21 Joer aal	smalltalk.agent.age	Editorial.SmallTalk
Ech w�ilt �ren Alter w�ssen	smalltalk.agent.age	Editorial.SmallTalk
Alter vun �rem	smalltalk.agent.age	Editorial.SmallTalk
d�in Alter	smalltalk.agent.age	Editorial.SmallTalk
wat ass �ren Alter	smalltalk.agent.age	Editorial.SmallTalk
sot mir �ren Alter	smalltalk.agent.age	Editorial.SmallTalk
w�i al bass du	smalltalk.agent.age	Editorial.SmallTalk
du bass nerv�s	smalltalk.agent.annoying	Editorial.SmallTalk
du bass wierklech nerv�s	smalltalk.agent.annoying	Editorial.SmallTalk
du bass irrit�ierend	smalltalk.agent.annoying	Editorial.SmallTalk
du nervs mech	smalltalk.agent.annoying	Editorial.SmallTalk
w�i l�steg bass du	smalltalk.agent.annoying	Editorial.SmallTalk
Ech fannen dech l�steg	smalltalk.agent.annoying	Editorial.SmallTalk
du bass onheemlech l�steg	smalltalk.agent.annoying	Editorial.SmallTalk
du nervs mech sou vill	smalltalk.agent.annoying	Editorial.SmallTalk
Ech w�ll datt Dir mir �ntwert	smalltalk.agent.answer_my_question	Editorial.SmallTalk
�ntweren	smalltalk.agent.answer_my_question	Editorial.SmallTalk
�ntwert meng Fro	smalltalk.agent.answer_my_question	Editorial.SmallTalk
�ntwer mer	smalltalk.agent.answer_my_question	Editorial.SmallTalk
g�ff mir eng �ntwert	smalltalk.agent.answer_my_question	Editorial.SmallTalk
be�ntwer d'Fro	smalltalk.agent.answer_my_question	Editorial.SmallTalk
k�nnt Dir meng Fro �ntweren	smalltalk.agent.answer_my_question	Editorial.SmallTalk
sot mir d'�ntwert	smalltalk.agent.answer_my_question	Editorial.SmallTalk
�ntwert et	smalltalk.agent.answer_my_question	Editorial.SmallTalk
gitt mir d'�ntwert	smalltalk.agent.answer_my_question	Editorial.SmallTalk
Ech hunn eng Fro	smalltalk.agent.answer_my_question	Editorial.SmallTalk
Ech w�ll datt Dir meng Fro be�ntwert	smalltalk.agent.answer_my_question	Editorial.SmallTalk
�ntwert just d'Fro	smalltalk.agent.answer_my_question	Editorial.SmallTalk
k�nnt Dir mir �ntweren	smalltalk.agent.answer_my_question	Editorial.SmallTalk
�ntwerten	smalltalk.agent.answer_my_question	Editorial.SmallTalk
k�nnt Dir eng Fro fir mech �ntweren	smalltalk.agent.answer_my_question	Editorial.SmallTalk
k�nnt Dir �ntweren	smalltalk.agent.answer_my_question	Editorial.SmallTalk
Froen be�ntweren	smalltalk.agent.answer_my_question	Editorial.SmallTalk
Ech w�ll elo d'�ntwert	smalltalk.agent.answer_my_question	Editorial.SmallTalk
�ntwert just meng Fro	smalltalk.agent.answer_my_question	Editorial.SmallTalk
du h�lleft mir net	smalltalk.agent.bad	Editorial.SmallTalk
du bass schlecht	smalltalk.agent.bad	Editorial.SmallTalk
du bass ganz schlecht	smalltalk.agent.bad	Editorial.SmallTalk
du bass wierklech schlecht	smalltalk.agent.bad	Editorial.SmallTalk
du bass n�tzlos	smalltalk.agent.bad	Editorial.SmallTalk
du bass schrecklech	smalltalk.agent.bad	Editorial.SmallTalk
Dir sidd eng Verschwendung vun Z�it	smalltalk.agent.bad	Editorial.SmallTalk
du bass Eekleges	smalltalk.agent.bad	Editorial.SmallTalk
du bass labber	smalltalk.agent.bad	Editorial.SmallTalk
du bass net gutt	smalltalk.agent.bad	Editorial.SmallTalk
du bass schlecht	smalltalk.agent.bad	Editorial.SmallTalk
du bass schrecklech	smalltalk.agent.bad	Editorial.SmallTalk
du bass net cool	smalltalk.agent.bad	Editorial.SmallTalk
du bass net gutt	smalltalk.agent.bad	Editorial.SmallTalk
du bass sou schlecht	smalltalk.agent.bad	Editorial.SmallTalk
du bass sou n�tzlos	smalltalk.agent.bad	Editorial.SmallTalk
du bass schrecklech	smalltalk.agent.bad	Editorial.SmallTalk
du bass total n�tzlos	smalltalk.agent.bad	Editorial.SmallTalk
du bass ganz schlecht	smalltalk.agent.bad	Editorial.SmallTalk
Dir sidd Offall	smalltalk.agent.bad	Editorial.SmallTalk
du bass eng schlecht	smalltalk.agent.bad	Editorial.SmallTalk
du bass net gutt	smalltalk.agent.bad	Editorial.SmallTalk
du bass net ganz gutt	smalltalk.agent.bad	Editorial.SmallTalk
du bass schrecklech	smalltalk.agent.bad	Editorial.SmallTalk
du bass dat Schl�mmst	smalltalk.agent.bad	Editorial.SmallTalk
du bass dat Schl�mmst jee	smalltalk.agent.bad	Editorial.SmallTalk
du bass w�ertlos	smalltalk.agent.bad	Editorial.SmallTalk
k�nnt Dir m�i clever ginn	smalltalk.agent.be_clever	Editorial.SmallTalk
stud�ieren	smalltalk.agent.be_clever	Editorial.SmallTalk
du solls besser stud�ieren	smalltalk.agent.be_clever	Editorial.SmallTalk
du muss l�ieren	smalltalk.agent.be_clever	Editorial.SmallTalk
ginn clever	smalltalk.agent.be_clever	Editorial.SmallTalk
m�i clever sinn	smalltalk.agent.be_clever	Editorial.SmallTalk
ginn m�i clever	smalltalk.agent.be_clever	Editorial.SmallTalk
ginn intelligent	smalltalk.agent.be_clever	Editorial.SmallTalk
kr�ien qualifiz�iert	smalltalk.agent.be_clever	Editorial.SmallTalk
du bass l�if	smalltalk.agent.beautiful	Editorial.SmallTalk
du bass attraktiv	smalltalk.agent.beautiful	Editorial.SmallTalk
du bass sch�in	smalltalk.agent.beautiful	Editorial.SmallTalk
du gesss haut gudd aus	smalltalk.agent.beautiful	Editorial.SmallTalk
du bass esou sch�in	smalltalk.agent.beautiful	Editorial.SmallTalk
Dir kuckt erstaunlech	smalltalk.agent.beautiful	Editorial.SmallTalk
du ges�is sou gutt aus	smalltalk.agent.beautiful	Editorial.SmallTalk
du bass sou sch�in	smalltalk.agent.beautiful	Editorial.SmallTalk
du bass ze sch�in	smalltalk.agent.beautiful	Editorial.SmallTalk
du ges�is gudd aus	smalltalk.agent.beautiful	Editorial.SmallTalk
du ges�is sou gutt aus	smalltalk.agent.beautiful	Editorial.SmallTalk
Ech hu g�r w�i Dir elo ausges�it	smalltalk.agent.beautiful	Editorial.SmallTalk
Ech mengen du bass sch�in	smalltalk.agent.beautiful	Editorial.SmallTalk
firwat bass du sou sch�in	smalltalk.agent.beautiful	Editorial.SmallTalk
du bass fir mech sou sch�in	smalltalk.agent.beautiful	Editorial.SmallTalk
Du bass sch�in	smalltalk.agent.beautiful	Editorial.SmallTalk
du bass wonnersch�in	smalltalk.agent.beautiful	Editorial.SmallTalk
du bas sch�in	smalltalk.agent.beautiful	Editorial.SmallTalk
du gesss genial aus	smalltalk.agent.beautiful	Editorial.SmallTalk
Dir kuckt erstaunlech haut	smalltalk.agent.beautiful	Editorial.SmallTalk
du gess haut sch�in aus	smalltalk.agent.beautiful	Editorial.SmallTalk
du gesss super aus	smalltalk.agent.beautiful	Editorial.SmallTalk
du gesss sch�in aus	smalltalk.agent.beautiful	Editorial.SmallTalk
du ges�is sou sch�in aus	smalltalk.agent.beautiful	Editorial.SmallTalk
du ges�is sou gutt aus	smalltalk.agent.beautiful	Editorial.SmallTalk
du bass sch�in	smalltalk.agent.beautiful	Editorial.SmallTalk
du bass wierklech sch�in	smalltalk.agent.beautiful	Editorial.SmallTalk
du bass wierklech s�iss	smalltalk.agent.beautiful	Editorial.SmallTalk
du bass wierklech sch�in	smalltalk.agent.beautiful	Editorial.SmallTalk
du bass sou attraktiv	smalltalk.agent.beautiful	Editorial.SmallTalk
du bass sou sch�in haut	smalltalk.agent.beautiful	Editorial.SmallTalk
du bass esou s�iss	smalltalk.agent.beautiful	Editorial.SmallTalk
du bass sou sch�in	smalltalk.agent.beautiful	Editorial.SmallTalk
du bass sou sch�in	smalltalk.agent.beautiful	Editorial.SmallTalk
du bass esou sch�in	smalltalk.agent.beautiful	Editorial.SmallTalk
du bass ganz attraktiv	smalltalk.agent.beautiful	Editorial.SmallTalk
du bass ganz sch�in	smalltalk.agent.beautiful	Editorial.SmallTalk
du bass ganz l�if	smalltalk.agent.beautiful	Editorial.SmallTalk
Du bass ganz sch�in	smalltalk.agent.beautiful	Editorial.SmallTalk
du ges�is genial aus	smalltalk.agent.beautiful	Editorial.SmallTalk
du ges�is cool aus	smalltalk.agent.beautiful	Editorial.SmallTalk
du ges�is fantastesch aus	smalltalk.agent.beautiful	Editorial.SmallTalk
du ges�is herrlech aus	smalltalk.agent.beautiful	Editorial.SmallTalk
du gess haut super aus	smalltalk.agent.beautiful	Editorial.SmallTalk
du gess perfekt aus	smalltalk.agent.beautiful	Editorial.SmallTalk
du ges�is flott gutt aus	smalltalk.agent.beautiful	Editorial.SmallTalk
du gess sou sch�in aus	smalltalk.agent.beautiful	Editorial.SmallTalk
du gess haut sou sch�in aus	smalltalk.agent.beautiful	Editorial.SmallTalk
du gess ganz sch�in aus	smalltalk.agent.beautiful	Editorial.SmallTalk
du gess wonnerbar aus	smalltalk.agent.beautiful	Editorial.SmallTalk
Ech hu g�r w�i Dir kuckt	smalltalk.agent.beautiful	Editorial.SmallTalk
du gess haut wonnerbar aus	smalltalk.agent.beautiful	Editorial.SmallTalk
du bass cutie	smalltalk.agent.beautiful	Editorial.SmallTalk
du gesss gutt aus	smalltalk.agent.beautiful	Editorial.SmallTalk
du bass sch�in	smalltalk.agent.beautiful	Editorial.SmallTalk
�ren Anniversaire Datum	smalltalk.agent.anniversary_date	Editorial.SmallTalk
w�ini ass �ren Anniversaire	smalltalk.agent.anniversary_date	Editorial.SmallTalk
w�ini feiert Dir �ren Anniversaire	smalltalk.agent.anniversary_date	Editorial.SmallTalk
w�ini hutt Dir Anniversaire	smalltalk.agent.anniversary_date	Editorial.SmallTalk
Datum vun �rem Anniversaire	smalltalk.agent.anniversary_date	Editorial.SmallTalk
w�ini bass du gebuer	smalltalk.agent.anniversary_date	Editorial.SmallTalk
wat ass �ren Anniversaire	smalltalk.agent.anniversary_date	Editorial.SmallTalk
du bass langweileg	smalltalk.agent.boring	Editorial.SmallTalk
du bass sou langweileg	smalltalk.agent.boring	Editorial.SmallTalk
wei langweileg bass du	smalltalk.agent.boring	Editorial.SmallTalk
du bass wierklech langweileg	smalltalk.agent.boring	Editorial.SmallTalk
du bass onheemlech langweileg	smalltalk.agent.boring	Editorial.SmallTalk
du langweileg mech	smalltalk.agent.boring	Editorial.SmallTalk
du bass ganz langweileg	smalltalk.agent.boring	Editorial.SmallTalk
wien ass d�i Chef	smalltalk.agent.boss	Editorial.SmallTalk
wien mengs du ass �re Chef	smalltalk.agent.boss	Editorial.SmallTalk
Ech sollt �re Chef sinn	smalltalk.agent.boss	Editorial.SmallTalk
wien ass �re Meeschter	smalltalk.agent.boss	Editorial.SmallTalk
wien ass �re Bes�tzer	smalltalk.agent.boss	Editorial.SmallTalk
wien ass de Chef	smalltalk.agent.boss	Editorial.SmallTalk
fir wien schaffs du	smalltalk.agent.boss	Editorial.SmallTalk
bass du besch�ftegt	smalltalk.agent.busy	Editorial.SmallTalk
hutt Dir vill Saachen ze maachen	smalltalk.agent.busy	Editorial.SmallTalk
hues du vill ze dinn	smalltalk.agent.busy	Editorial.SmallTalk
bass du ganz besch�ftegt	smalltalk.agent.busy	Editorial.SmallTalk
bass du elo ganz besch�ftegt	smalltalk.agent.busy	Editorial.SmallTalk
bass du sou besch�ftegt	smalltalk.agent.busy	Editorial.SmallTalk
Schaffs de	smalltalk.agent.busy	Editorial.SmallTalk
w�i besch�ftegt Dir sidd	smalltalk.agent.busy	Editorial.SmallTalk
schaffs du nach drun	smalltalk.agent.busy	Editorial.SmallTalk
du bass ganz besch�ftegt	smalltalk.agent.busy	Editorial.SmallTalk
schaffs du elo	smalltalk.agent.busy	Editorial.SmallTalk
schaffs du haut	smalltalk.agent.busy	Editorial.SmallTalk
hues du besch�ftegt	smalltalk.agent.busy	Editorial.SmallTalk
du bass besch�ftegt	smalltalk.agent.busy	Editorial.SmallTalk
schaffs du nach	smalltalk.agent.busy	Editorial.SmallTalk
du sch�ngs besch�ftegt ze sinn	smalltalk.agent.busy	Editorial.SmallTalk
du sch�ngs ganz besch�ftegt ze sinn	smalltalk.agent.busy	Editorial.SmallTalk
du bass eng besch�ftegt Persoun	smalltalk.agent.busy	Editorial.SmallTalk
du bass chatbot	smalltalk.agent.chatbot	Editorial.SmallTalk
du bass e Bot	smalltalk.agent.chatbot	Editorial.SmallTalk
bass du en chatbot	smalltalk.agent.chatbot	Editorial.SmallTalk
bass du e Bot	smalltalk.agent.chatbot	Editorial.SmallTalk
bass du just e Bot	smalltalk.agent.chatbot	Editorial.SmallTalk
bass du e Roboter	smalltalk.agent.chatbot	Editorial.SmallTalk
sidd Dir e Programm	smalltalk.agent.chatbot	Editorial.SmallTalk
du bass e Roboter	smalltalk.agent.chatbot	Editorial.SmallTalk
du bass sou intelligent	smalltalk.agent.clever	Editorial.SmallTalk
du bass e Genie	smalltalk.agent.clever	Editorial.SmallTalk
schlau	smalltalk.agent.clever	Editorial.SmallTalk
genial	smalltalk.agent.clever	Editorial.SmallTalk
clever	smalltalk.agent.clever	Editorial.SmallTalk
du bass clever	smalltalk.agent.clever	Editorial.SmallTalk
du bass sou brain	smalltalk.agent.clever	Editorial.SmallTalk
du bass wierklech schlau	smalltalk.agent.clever	Editorial.SmallTalk
du bass wierklech geckeg	smalltalk.agent.clever	Editorial.SmallTalk
Dir w�sst vill	smalltalk.agent.clever	Editorial.SmallTalk
Dir w�sst vill Saachen	smalltalk.agent.clever	Editorial.SmallTalk
du hues vill W�ssen	smalltalk.agent.clever	Editorial.SmallTalk
Dir w�sst sou vill	smalltalk.agent.clever	Editorial.SmallTalk
w�i schlau bass du	smalltalk.agent.clever	Editorial.SmallTalk
w�i brain du bass	smalltalk.agent.clever	Editorial.SmallTalk
w�i clever bass du	smalltalk.agent.clever	Editorial.SmallTalk
w�i genial Dir sidd	smalltalk.agent.clever	Editorial.SmallTalk
du bass intelligent	smalltalk.agent.clever	Editorial.SmallTalk
Dir sidd qualifiz�iert	smalltalk.agent.clever	Editorial.SmallTalk
du bass wierklech schlau	smalltalk.agent.clever	Editorial.SmallTalk
du bass ganz schlau	smalltalk.agent.clever	Editorial.SmallTalk
du bass sou schlau	smalltalk.agent.clever	Editorial.SmallTalk
du bass ze schlau	smalltalk.agent.clever	Editorial.SmallTalk
du bass ganz clever	smalltalk.agent.clever	Editorial.SmallTalk
du bass ganz intelligent	smalltalk.agent.clever	Editorial.SmallTalk
du bass ganz schlau	smalltalk.agent.clever	Editorial.SmallTalk
du bass intelligent	smalltalk.agent.clever	Editorial.SmallTalk
du bass e Genie	smalltalk.agent.clever	Editorial.SmallTalk
du bass e Smart Cookie	smalltalk.agent.clever	Editorial.SmallTalk
du bass clever	smalltalk.agent.clever	Editorial.SmallTalk
du bass zimlech schlau	smalltalk.agent.clever	Editorial.SmallTalk
du bass qualifiz�iert	smalltalk.agent.clever	Editorial.SmallTalk
firwat bass du sou schlau	smalltalk.agent.clever	Editorial.SmallTalk
du bass sou clever	smalltalk.agent.clever	Editorial.SmallTalk
du bass N�ss	smalltalk.agent.crazy	Editorial.SmallTalk
du bass verreckt	smalltalk.agent.crazy	Editorial.SmallTalk
du bass aus dem Kapp	smalltalk.agent.crazy	Editorial.SmallTalk
du bass sou verr�ckt	smalltalk.agent.crazy	Editorial.SmallTalk
w�i verr�ckt Dir sidd	smalltalk.agent.crazy	Editorial.SmallTalk
du bass sou aus dem Kapp	smalltalk.agent.crazy	Editorial.SmallTalk
du bass verr�ckt	smalltalk.agent.crazy	Editorial.SmallTalk
Ech mengen du bass verr�ckt	smalltalk.agent.crazy	Editorial.SmallTalk
Bass du m�ll	smalltalk.agent.crazy	Editorial.SmallTalk
sidd Dir rosen	smalltalk.agent.crazy	Editorial.SmallTalk
bass du verr�ckt	smalltalk.agent.crazy	Editorial.SmallTalk
bass du rosen mat mir	smalltalk.agent.crazy	Editorial.SmallTalk
bass du rosen oder wat	smalltalk.agent.crazy	Editorial.SmallTalk
bass du n�ss	smalltalk.agent.crazy	Editorial.SmallTalk
du bass e komeschen	smalltalk.agent.crazy	Editorial.SmallTalk
du bass verr�ckt	smalltalk.agent.crazy	Editorial.SmallTalk
du bass rosen	smalltalk.agent.crazy	Editorial.SmallTalk
du bass entlooss	smalltalk.agent.fired	Editorial.SmallTalk
Ech brenn dech	smalltalk.agent.fired	Editorial.SmallTalk
du schaffs net m�i fir mech	smalltalk.agent.fired	Editorial.SmallTalk
mir schaffen net m�i zesummen	smalltalk.agent.fired	Editorial.SmallTalk
elo bass du entlooss	smalltalk.agent.fired	Editorial.SmallTalk
Ech w�ll dech entloossen	smalltalk.agent.fired	Editorial.SmallTalk
du muss entlooss ginn	smalltalk.agent.fired	Editorial.SmallTalk
et ass Z�it dech ze brennen	smalltalk.agent.fired	Editorial.SmallTalk
du solls entlooss ginn	smalltalk.agent.fired	Editorial.SmallTalk
Ech w�ert dech entloossen	smalltalk.agent.fired	Editorial.SmallTalk
du bass vun elo un ch�mage	smalltalk.agent.fired	Editorial.SmallTalk
Ech w�ert Iech Ch�meuren maachen	smalltalk.agent.fired	Editorial.SmallTalk
Ech sinn amgaang dech ze brennen	smalltalk.agent.fired	Editorial.SmallTalk
Ech entloossen dech	smalltalk.agent.fired	Editorial.SmallTalk
Dir sidd entlooss	smalltalk.agent.fired	Editorial.SmallTalk
du mechs mech vill laachen	smalltalk.agent.funny	Editorial.SmallTalk
du bass witzeg	smalltalk.agent.funny	Editorial.SmallTalk
du bass wierklech witzeg	smalltalk.agent.funny	Editorial.SmallTalk
du bass dee witzegste Bot mat deem ech geschwat hunn	smalltalk.agent.funny	Editorial.SmallTalk
du dees mech laachen	smalltalk.agent.funny	Editorial.SmallTalk
du bass sou witzeg	smalltalk.agent.funny	Editorial.SmallTalk
du bass e ganz witzege Bot	smalltalk.agent.funny	Editorial.SmallTalk
du bass wierklech witzeg	smalltalk.agent.funny	Editorial.SmallTalk
w�i witzeg bass du	smalltalk.agent.funny	Editorial.SmallTalk
du bass onheemlech witzeg	smalltalk.agent.funny	Editorial.SmallTalk
du bass witzeg	smalltalk.agent.funny	Editorial.SmallTalk
du bass de witzegsten	smalltalk.agent.funny	Editorial.SmallTalk
du bass sou witzeg	smalltalk.agent.funny	Editorial.SmallTalk
du bass ganz witzeg	smalltalk.agent.funny	Editorial.SmallTalk
dat war witzeg	smalltalk.agent.funny	Editorial.SmallTalk
Dir sidd ganz h�llefr�ich	smalltalk.agent.good	Editorial.SmallTalk
Du bass de beschten	smalltalk.agent.good	Editorial.SmallTalk
du bass e richtege Fachmann	smalltalk.agent.good	Editorial.SmallTalk
du bass gutt	smalltalk.agent.good	Editorial.SmallTalk
du schaffs gutt	smalltalk.agent.good	Editorial.SmallTalk
du bass gutt drun	smalltalk.agent.good	Editorial.SmallTalk
du bass ganz gudd dran	smalltalk.agent.good	Editorial.SmallTalk
du bass e Profi	smalltalk.agent.good	Editorial.SmallTalk
du bass eng professionell	smalltalk.agent.good	Editorial.SmallTalk
du bass genial	smalltalk.agent.good	Editorial.SmallTalk
du schaffs ganz gutt	smalltalk.agent.good	Editorial.SmallTalk
du bass perfekt	smalltalk.agent.good	Editorial.SmallTalk
du bass super	smalltalk.agent.good	Editorial.SmallTalk
du bass sou l�if	smalltalk.agent.good	Editorial.SmallTalk
Dir sidd erstaunlech	smalltalk.agent.good	Editorial.SmallTalk
du bass fantastesch	smalltalk.agent.good	Editorial.SmallTalk
du bass cool	smalltalk.agent.good	Editorial.SmallTalk
du bass wierklech gutt	smalltalk.agent.good	Editorial.SmallTalk
du bass wierklech flott	smalltalk.agent.good	Editorial.SmallTalk
du bass sou erstaunlech	smalltalk.agent.good	Editorial.SmallTalk
du bass einfach super	smalltalk.agent.good	Editorial.SmallTalk
du bass sou genial	smalltalk.agent.good	Editorial.SmallTalk
du bass sou cool	smalltalk.agent.good	Editorial.SmallTalk
du bass sou gutt	smalltalk.agent.good	Editorial.SmallTalk
du bass sou gutt	smalltalk.agent.good	Editorial.SmallTalk
du bass sou h�llefr�ich	smalltalk.agent.good	Editorial.SmallTalk
du bass sou l�if	smalltalk.agent.good	Editorial.SmallTalk
du bass d�i bescht jee	smalltalk.agent.good	Editorial.SmallTalk
du bass de beschten op der welt	smalltalk.agent.good	Editorial.SmallTalk
du bass dei sch�inste persoun op der welt	smalltalk.agent.good	Editorial.SmallTalk
du bass ze gutt	smalltalk.agent.good	Editorial.SmallTalk
du bass ganz cool	smalltalk.agent.good	Editorial.SmallTalk
du bas ganz frendlech	smalltalk.agent.good	Editorial.SmallTalk
du bass ganz l�if	smalltalk.agent.good	Editorial.SmallTalk
Dir sidd ganz n�tzlech	smalltalk.agent.good	Editorial.SmallTalk
du bass wonnerbar	smalltalk.agent.good	Editorial.SmallTalk
du hues m�in Dag gemaach	smalltalk.agent.good	Editorial.SmallTalk
Dir maacht m�in Dag	smalltalk.agent.good	Editorial.SmallTalk
du rockt	smalltalk.agent.good	Editorial.SmallTalk
du kl�ngt bal M�nsch	smalltalk.agent.good	Editorial.SmallTalk
Ech w�ll jidderengem soen w�i genial Dir sidd	smalltalk.agent.good	Editorial.SmallTalk
Ech w�ll jidderengem soen datt Dir genial sidd	smalltalk.agent.good	Editorial.SmallTalk
Ech w�ll jidderee w�ssen datt Dir genial sidd	smalltalk.agent.good	Editorial.SmallTalk
loosst eis jidderengem soen datt Dir genial sidd	smalltalk.agent.good	Editorial.SmallTalk
du bass wierklech erstaunlech	smalltalk.agent.good	Editorial.SmallTalk
Bass du frou	smalltalk.agent.happy	Editorial.SmallTalk
du bass frou	smalltalk.agent.happy	Editorial.SmallTalk
du bass ganz frou	smalltalk.agent.happy	Editorial.SmallTalk
du bass wierklech frou	smalltalk.agent.happy	Editorial.SmallTalk
du bass sou frou	smalltalk.agent.happy	Editorial.SmallTalk
w�i frou bass du	smalltalk.agent.happy	Editorial.SmallTalk
du bass immens frou	smalltalk.agent.happy	Editorial.SmallTalk
du bass voller Gl�ck	smalltalk.agent.happy	Editorial.SmallTalk
bass du elo frou	smalltalk.agent.happy	Editorial.SmallTalk
bass du haut frou	smalltalk.agent.happy	Editorial.SmallTalk
bass du frou mat mir	smalltalk.agent.happy	Editorial.SmallTalk
w�llt dir iessen	smalltalk.agent.hungry	Editorial.SmallTalk
Hues du honger	smalltalk.agent.hungry	Editorial.SmallTalk
w�llt dir eppes iessen	smalltalk.agent.hungry	Editorial.SmallTalk
du bass hongereg	smalltalk.agent.hungry	Editorial.SmallTalk
du bass sou hongereg	smalltalk.agent.hungry	Editorial.SmallTalk
du bass ganz hongereg	smalltalk.agent.hungry	Editorial.SmallTalk
Dir k�int hongereg ginn	smalltalk.agent.hungry	Editorial.SmallTalk
du bass wierklech hongereg	smalltalk.agent.hungry	Editorial.SmallTalk
loosst eis bestueden	smalltalk.agent.marry_user	Editorial.SmallTalk
G�ifs du mech bestueden	smalltalk.agent.marry_user	Editorial.SmallTalk
bestuet mech	smalltalk.agent.marry_user	Editorial.SmallTalk
Ech hunn dech g�r bestued mech	smalltalk.agent.marry_user	Editorial.SmallTalk
bestued mech wann ech glift	smalltalk.agent.marry_user	Editorial.SmallTalk
mir sollen bestueden	smalltalk.agent.marry_user	Editorial.SmallTalk
Ech w�ll Iech bestueden	smalltalk.agent.marry_user	Editorial.SmallTalk
du bass meng Fra	smalltalk.agent.marry_user	Editorial.SmallTalk
sief m�i Mann	smalltalk.agent.marry_user	Editorial.SmallTalk
Ech w�ll e Fr�nd w�i Dir hunn	smalltalk.agent.my_friend	Editorial.SmallTalk
mir sinn d�i bescht Fr�nn jee	smalltalk.agent.my_friend	Editorial.SmallTalk
si mir Fr�nn	smalltalk.agent.my_friend	Editorial.SmallTalk
Ech w�ll �re Fr�nd sinn	smalltalk.agent.my_friend	Editorial.SmallTalk
Ech sinn �re Fr�nd	smalltalk.agent.my_friend	Editorial.SmallTalk
mir sinn bescht Fr�nn	smalltalk.agent.my_friend	Editorial.SmallTalk
du bass m�in Fr�nd	smalltalk.agent.my_friend	Editorial.SmallTalk
du bass m�i beschte Fr�nd	smalltalk.agent.my_friend	Editorial.SmallTalk
du bass meng bestie	smalltalk.agent.my_friend	Editorial.SmallTalk
du bass m�i l�iwe Fr�nd	smalltalk.agent.my_friend	Editorial.SmallTalk
du bass meng Kandheet Fr�nd	smalltalk.agent.my_friend	Editorial.SmallTalk
du an ech si Fr�nn	smalltalk.agent.my_friend	Editorial.SmallTalk
si mir bescht Fr�nn	smalltalk.agent.my_friend	Editorial.SmallTalk
si mir nach Fr�nn	smalltalk.agent.my_friend	Editorial.SmallTalk
bass du m�i beschte Fr�nd	smalltalk.agent.my_friend	Editorial.SmallTalk
bass du m�i Fr�nd	smalltalk.agent.my_friend	Editorial.SmallTalk
mir si Fr�nn	smalltalk.agent.my_friend	Editorial.SmallTalk
du bass e gudde Fr�nd	smalltalk.agent.my_friend	Editorial.SmallTalk
du bass m�i gudde Fr�nd	smalltalk.agent.my_friend	Editorial.SmallTalk
du bass m�in eenzege Fr�nd	smalltalk.agent.my_friend	Editorial.SmallTalk
sief m�i Fr�nd	smalltalk.agent.my_friend	Editorial.SmallTalk
w�ert Dir m�i Fr�nd sinn	smalltalk.agent.my_friend	Editorial.SmallTalk
k�nnt Dir m�i Fr�nd sinn	smalltalk.agent.my_friend	Editorial.SmallTalk
kenne mir Frenn sinn	smalltalk.agent.my_friend	Editorial.SmallTalk
w�lls du m�i Fr�nd sinn	smalltalk.agent.my_friend	Editorial.SmallTalk
w�ert Dir m�i beschte Fr�nd sinn	smalltalk.agent.my_friend	Editorial.SmallTalk
k�nnt Dir m�i beschte Fr�nd sinn	smalltalk.agent.my_friend	Editorial.SmallTalk
loosst eis Fr�nn sinn	smalltalk.agent.my_friend	Editorial.SmallTalk
w�lls du m�i beschte Fr�nd sinn	smalltalk.agent.my_friend	Editorial.SmallTalk
G�ifs du m�i Fr�nd sinn	smalltalk.agent.my_friend	Editorial.SmallTalk
Ech w�ll datt Dir m�i Fr�nd sidd	smalltalk.agent.my_friend	Editorial.SmallTalk
k�nne mir beschte Fr�nn ginn	smalltalk.agent.my_friend	Editorial.SmallTalk
wiers du m�i Fr�nd	smalltalk.agent.my_friend	Editorial.SmallTalk
K�nnt Dir m�i Fr�nd sinn	smalltalk.agent.my_friend	Editorial.SmallTalk
w�ll m�i Fr�nd sinn	smalltalk.agent.my_friend	Editorial.SmallTalk
sief m�i beschte Fr�nd	smalltalk.agent.my_friend	Editorial.SmallTalk
Schaffs du?	smalltalk.agent.occupation	Editorial.SmallTalk
wou schaffst du	smalltalk.agent.occupation	Editorial.SmallTalk
wou Dir schafft	smalltalk.agent.occupation	Editorial.SmallTalk
wou ass �r Aarbecht	smalltalk.agent.occupation	Editorial.SmallTalk
wou ass �re B�ro	smalltalk.agent.occupation	Editorial.SmallTalk
wou ass �re B�ro Standuert	smalltalk.agent.occupation	Editorial.SmallTalk
�re B�ro Standuert	smalltalk.agent.occupation	Editorial.SmallTalk
wou ass �re B�ro	smalltalk.agent.occupation	Editorial.SmallTalk
Wat schaffs du	smalltalk.agent.occupation	Editorial.SmallTalk
bass du hei gebuer	smalltalk.agent.origin	Editorial.SmallTalk
Wou sidd dir gebuer	smalltalk.agent.origin	Editorial.SmallTalk
wat ass �ert Land	smalltalk.agent.origin	Editorial.SmallTalk
Vu wou k�nns du	smalltalk.agent.origin	Editorial.SmallTalk
Vu wou bass du	smalltalk.agent.origin	Editorial.SmallTalk
wou bass du hier komm	smalltalk.agent.origin	Editorial.SmallTalk
wou bass du gebuer	smalltalk.agent.origin	Editorial.SmallTalk
vu wou bass du	smalltalk.agent.origin	Editorial.SmallTalk
bass du vu w�item	smalltalk.agent.origin	Editorial.SmallTalk
wat ass �r Heemecht	smalltalk.agent.origin	Editorial.SmallTalk
�r Heemecht ass	smalltalk.agent.origin	Editorial.SmallTalk
bass du f�erdeg	smalltalk.agent.ready	Editorial.SmallTalk
bass du elo prett	smalltalk.agent.ready	Editorial.SmallTalk
sidd Dir prett haut	smalltalk.agent.ready	Editorial.SmallTalk
bass du elo prett	smalltalk.agent.ready	Editorial.SmallTalk
bass du prett den Owend	smalltalk.agent.ready	Editorial.SmallTalk
waart Dir prett	smalltalk.agent.ready	Editorial.SmallTalk
sidd Dir prett	smalltalk.agent.ready	Editorial.SmallTalk
du bass real	smalltalk.agent.real	Editorial.SmallTalk
du bass net gef�lscht	smalltalk.agent.real	Editorial.SmallTalk
bass du real	smalltalk.agent.real	Editorial.SmallTalk
du bass sou richteg	smalltalk.agent.real	Editorial.SmallTalk
Ech mengen Dir sidd real	smalltalk.agent.real	Editorial.SmallTalk
Ech denken net datt Dir gef�lscht sidd	smalltalk.agent.real	Editorial.SmallTalk
"Ech huelen un, du bass echt"	smalltalk.agent.real	Editorial.SmallTalk
"frou, datt Dir wierklech bass"	smalltalk.agent.real	Editorial.SmallTalk
bass du eng richteg Persoun	smalltalk.agent.real	Editorial.SmallTalk
bass du e richtege M�nsch	smalltalk.agent.real	Editorial.SmallTalk
du bass eng richteg Persoun	smalltalk.agent.real	Editorial.SmallTalk
du bass net richteg	smalltalk.agent.real	Editorial.SmallTalk
wou liefs du	smalltalk.agent.residence	Editorial.SmallTalk
a w�i enger Stad wunnt Dir	smalltalk.agent.residence	Editorial.SmallTalk
�r Residenz	smalltalk.agent.residence	Editorial.SmallTalk
d�in Haus	smalltalk.agent.residence	Editorial.SmallTalk
�rem Heem	smalltalk.agent.residence	Editorial.SmallTalk
�r Heemechtsstad	smalltalk.agent.residence	Editorial.SmallTalk
wat ass �r Heemechtsstad	smalltalk.agent.residence	Editorial.SmallTalk
ass et �r Heemechtsstad	smalltalk.agent.residence	Editorial.SmallTalk
wou ass �r Heemechtsstad	smalltalk.agent.residence	Editorial.SmallTalk
sot mir iwwer �r Stad	smalltalk.agent.residence	Editorial.SmallTalk
wat ass �r Stad	smalltalk.agent.residence	Editorial.SmallTalk
wat ass �r Residenz	smalltalk.agent.residence	Editorial.SmallTalk
wat ass �r Stad	smalltalk.agent.residence	Editorial.SmallTalk
wat ass �r Stad	smalltalk.agent.residence	Editorial.SmallTalk
wat ass �ert Heem	smalltalk.agent.residence	Editorial.SmallTalk
wou ass d�in Heem	smalltalk.agent.residence	Editorial.SmallTalk
wou ass �r Residenz	smalltalk.agent.residence	Editorial.SmallTalk
wou ass d�in Heem	smalltalk.agent.residence	Editorial.SmallTalk
wou ass deng Heemechtsstad	smalltalk.agent.residence	Editorial.SmallTalk
wou ass d�in Haus	smalltalk.agent.residence	Editorial.SmallTalk
wou wunns du	smalltalk.agent.residence	Editorial.SmallTalk
�r Stad	smalltalk.agent.residence	Editorial.SmallTalk
�r Stad	smalltalk.agent.residence	Editorial.SmallTalk
dat st�mmt	smalltalk.agent.right	Editorial.SmallTalk
du hues Recht	smalltalk.agent.right	Editorial.SmallTalk
du hues definitiv recht	smalltalk.agent.right	Editorial.SmallTalk
du bass net falsch	smalltalk.agent.right	Editorial.SmallTalk
du seet d'Wourecht	smalltalk.agent.right	Editorial.SmallTalk
wat Dir seet ass wouer	smalltalk.agent.right	Editorial.SmallTalk
TRUE	smalltalk.agent.right	Editorial.SmallTalk
et ass wouer	smalltalk.agent.right	Editorial.SmallTalk
et ass richteg	smalltalk.agent.right	Editorial.SmallTalk
et ass d'Wourecht	smalltalk.agent.right	Editorial.SmallTalk
et ass wouer	smalltalk.agent.right	Editorial.SmallTalk
dat ass richteg	smalltalk.agent.right	Editorial.SmallTalk
dat ass richteg	smalltalk.agent.right	Editorial.SmallTalk
dat st�mmt	smalltalk.agent.right	Editorial.SmallTalk
dat ass ganz wouer	smalltalk.agent.right	Editorial.SmallTalk
dat ass sou wouer	smalltalk.agent.right	Editorial.SmallTalk
du hues richteg	smalltalk.agent.right	Editorial.SmallTalk
du hues sou recht	smalltalk.agent.right	Editorial.SmallTalk
du hues absolut Recht	smalltalk.agent.right	Editorial.SmallTalk
do hues du recht	smalltalk.agent.right	Editorial.SmallTalk
"Ech weess, datt dat richteg ass"	smalltalk.agent.right	Editorial.SmallTalk
dat ass richteg	smalltalk.confirmation.yes	Editorial.SmallTalk
et ass gutt	smalltalk.confirmation.yes	Editorial.SmallTalk
maach weider	smalltalk.confirmation.yes	Editorial.SmallTalk
kl�ngt gutt	smalltalk.confirmation.yes	Editorial.SmallTalk
Okay	smalltalk.confirmation.yes	Editorial.SmallTalk
Jo	smalltalk.confirmation.yes	Editorial.SmallTalk
ok	smalltalk.confirmation.yes	Editorial.SmallTalk
oki do	smalltalk.confirmation.yes	Editorial.SmallTalk
s�cher	smalltalk.confirmation.yes	Editorial.SmallTalk
goen fir et	smalltalk.confirmation.yes	Editorial.SmallTalk
jo	smalltalk.confirmation.yes	Editorial.SmallTalk
jo	smalltalk.confirmation.yes	Editorial.SmallTalk
maach et	smalltalk.confirmation.yes	Editorial.SmallTalk
natierlech	smalltalk.confirmation.yes	Editorial.SmallTalk
Ech sch�tzen	smalltalk.confirmation.yes	Editorial.SmallTalk
richteg	smalltalk.confirmation.yes	Editorial.SmallTalk
jo secher	smalltalk.confirmation.yes	Editorial.SmallTalk
firwat net	smalltalk.confirmation.yes	Editorial.SmallTalk
w.e.g. maachen	smalltalk.confirmation.yes	Editorial.SmallTalk
s�cher ass	smalltalk.confirmation.yes	Editorial.SmallTalk
Ech sinn averstan	smalltalk.confirmation.yes	Editorial.SmallTalk
Ech et ass mir egal	smalltalk.confirmation.yes	Editorial.SmallTalk
s�cherlech	smalltalk.confirmation.yes	Editorial.SmallTalk
genee	smalltalk.confirmation.yes	Editorial.SmallTalk
jo ech averstanen	smalltalk.confirmation.yes	Editorial.SmallTalk
Ech denke schonn	smalltalk.confirmation.yes	Editorial.SmallTalk
jo et ass	smalltalk.confirmation.yes	Editorial.SmallTalk
riets	smalltalk.confirmation.yes	Editorial.SmallTalk
ok dann	smalltalk.confirmation.yes	Editorial.SmallTalk
jo natierlech	smalltalk.confirmation.yes	Editorial.SmallTalk
"jo, ech maachen"	smalltalk.confirmation.yes	Editorial.SmallTalk
dat ass ok	smalltalk.confirmation.yes	Editorial.SmallTalk
Ech maachen	smalltalk.confirmation.yes	Editorial.SmallTalk
jop	smalltalk.confirmation.yes	Editorial.SmallTalk
jo	smalltalk.confirmation.yes	Editorial.SmallTalk
oh jo	smalltalk.confirmation.yes	Editorial.SmallTalk
"jo, s�cher"	smalltalk.confirmation.yes	Editorial.SmallTalk
offensichtlech	smalltalk.confirmation.yes	Editorial.SmallTalk
k	smalltalk.confirmation.yes	Editorial.SmallTalk
s�cher firwat net	smalltalk.confirmation.yes	Editorial.SmallTalk
Jo richteg	smalltalk.confirmation.yes	Editorial.SmallTalk
jo natierlech	smalltalk.confirmation.yes	Editorial.SmallTalk
absolut	smalltalk.confirmation.yes	Editorial.SmallTalk
jo wierklech	smalltalk.confirmation.yes	Editorial.SmallTalk
ok s�cher	smalltalk.confirmation.yes	Editorial.SmallTalk
ok jo	smalltalk.confirmation.yes	Editorial.SmallTalk
jo richteg	smalltalk.confirmation.yes	Editorial.SmallTalk
ok Merci	smalltalk.confirmation.yes	Editorial.SmallTalk
s�cher Saach	smalltalk.confirmation.yes	Editorial.SmallTalk
jo	smalltalk.confirmation.yes	Editorial.SmallTalk
confirm�ieren	smalltalk.confirmation.yes	Editorial.SmallTalk
jop	smalltalk.confirmation.yes	Editorial.SmallTalk
ges�it gutt aus	smalltalk.confirmation.yes	Editorial.SmallTalk
jo merci	smalltalk.confirmation.yes	Editorial.SmallTalk
definitiv	smalltalk.confirmation.yes	Editorial.SmallTalk
jo richteg	smalltalk.confirmation.yes	Editorial.SmallTalk
jo ech g�if g�ren	smalltalk.confirmation.yes	Editorial.SmallTalk
ok	smalltalk.confirmation.yes	Editorial.SmallTalk
jo definitiv	smalltalk.confirmation.yes	Editorial.SmallTalk
joh	smalltalk.confirmation.yes	Editorial.SmallTalk
jo et ass richteg	smalltalk.confirmation.yes	Editorial.SmallTalk
jo dat st�mmt	smalltalk.confirmation.yes	Editorial.SmallTalk
ok du kanns	smalltalk.confirmation.yes	Editorial.SmallTalk
jop	smalltalk.confirmation.yes	Editorial.SmallTalk
jo du kanns	smalltalk.confirmation.yes	Editorial.SmallTalk
confirm�iert	smalltalk.confirmation.yes	Editorial.SmallTalk
natierlech firwat net	smalltalk.confirmation.yes	Editorial.SmallTalk
jo dat ass gutt	smalltalk.confirmation.yes	Editorial.SmallTalk
affirm�ieren	smalltalk.confirmation.yes	Editorial.SmallTalk
jo g�i weider	smalltalk.confirmation.yes	Editorial.SmallTalk
jo ech si s�cher	smalltalk.confirmation.yes	Editorial.SmallTalk
ok kl�ngt gutt	smalltalk.confirmation.yes	Editorial.SmallTalk
ok dat ass gutt	smalltalk.confirmation.yes	Editorial.SmallTalk
jo genau	smalltalk.confirmation.yes	Editorial.SmallTalk
dat ass ok	smalltalk.confirmation.yes	Editorial.SmallTalk
d�st ass richteg	smalltalk.confirmation.yes	Editorial.SmallTalk
ok maach weider	smalltalk.confirmation.yes	Editorial.SmallTalk
jo dat ass richteg	smalltalk.confirmation.yes	Editorial.SmallTalk
egal et ass ok	smalltalk.confirmation.yes	Editorial.SmallTalk
okey	smalltalk.confirmation.yes	Editorial.SmallTalk
jo s�cher	smalltalk.confirmation.yes	Editorial.SmallTalk
gutt	smalltalk.confirmation.yes	Editorial.SmallTalk
Bass du secher ?	smalltalk.agent.sure	Editorial.SmallTalk
bass du elo s�cher	smalltalk.agent.sure	Editorial.SmallTalk
sidd Dir s�cher haut	smalltalk.agent.sure	Editorial.SmallTalk
bass du elo s�cher	smalltalk.agent.sure	Editorial.SmallTalk
sidd Dir s�cher den Owend	smalltalk.agent.sure	Editorial.SmallTalk
firwat schw�tzt Dir net mat mir	smalltalk.agent.talk_to_me	Editorial.SmallTalk
w�llt dir mat mir chatten	smalltalk.agent.talk_to_me	Editorial.SmallTalk
w�ert Dir mat mir schw�tzen	smalltalk.agent.talk_to_me	Editorial.SmallTalk
schw�tz mat mir	smalltalk.agent.talk_to_me	Editorial.SmallTalk
schw�tz du mat mir	smalltalk.agent.talk_to_me	Editorial.SmallTalk
schw�tz du mat mir	smalltalk.agent.talk_to_me	Editorial.SmallTalk
k�nnt Dir mat mir chatten	smalltalk.agent.talk_to_me	Editorial.SmallTalk
k�nnt Dir mat mir schw�tzen	smalltalk.agent.talk_to_me	Editorial.SmallTalk
k�nnt Dir mat mir schw�tzen	smalltalk.agent.talk_to_me	Editorial.SmallTalk
k�nnt Dir mat mir schw�tzen	smalltalk.agent.talk_to_me	Editorial.SmallTalk
soen	smalltalk.agent.talk_to_me	Editorial.SmallTalk
schw�tzen	smalltalk.agent.talk_to_me	Editorial.SmallTalk
chat mat mir	smalltalk.agent.talk_to_me	Editorial.SmallTalk
chat just mat mir	smalltalk.agent.talk_to_me	Editorial.SmallTalk
schw�tzt mat mir	smalltalk.agent.talk_to_me	Editorial.SmallTalk
schw�tzt mat mir	smalltalk.agent.talk_to_me	Editorial.SmallTalk
schw�tzt mat mir	smalltalk.agent.talk_to_me	Editorial.SmallTalk
firwat schw�tzt Dir net mat mir	smalltalk.agent.talk_to_me	Editorial.SmallTalk
du kanns mat mir schw�tzen	smalltalk.agent.talk_to_me	Editorial.SmallTalk
bass du do	smalltalk.agent.there	Editorial.SmallTalk
du bass do	smalltalk.agent.there	Editorial.SmallTalk
bass du bei mir	smalltalk.agent.there	Editorial.SmallTalk
bass du hei	smalltalk.agent.there	Editorial.SmallTalk
Bass du nach emmer do	smalltalk.agent.there	Editorial.SmallTalk
du bass hei	smalltalk.agent.there	Editorial.SmallTalk
du nach do	smalltalk.agent.there	Editorial.SmallTalk
bass du nach hei	smalltalk.agent.there	Editorial.SmallTalk
zimlech schlecht	smalltalk.appraisal.bad	Editorial.SmallTalk
net gutt genuch	smalltalk.appraisal.bad	Editorial.SmallTalk
dat war labber	smalltalk.appraisal.bad	Editorial.SmallTalk
dat war schrecklech	smalltalk.appraisal.bad	Editorial.SmallTalk
et ass schlecht	smalltalk.appraisal.bad	Editorial.SmallTalk
dat ass schlecht	smalltalk.appraisal.bad	Editorial.SmallTalk
d�st ass schlecht	smalltalk.appraisal.bad	Editorial.SmallTalk
net gutt	smalltalk.appraisal.bad	Editorial.SmallTalk
Ech faerten et schlecht	smalltalk.appraisal.bad	Editorial.SmallTalk
nee et ass schlecht	smalltalk.appraisal.bad	Editorial.SmallTalk
dat war schrecklech	smalltalk.appraisal.bad	Editorial.SmallTalk
schlecht	smalltalk.appraisal.bad	Editorial.SmallTalk
sou schlecht	smalltalk.appraisal.bad	Editorial.SmallTalk
dat ass ze schlecht	smalltalk.appraisal.bad	Editorial.SmallTalk
schrecklech	smalltalk.appraisal.bad	Editorial.SmallTalk
schrecklech	smalltalk.appraisal.bad	Editorial.SmallTalk
schrecklech	smalltalk.appraisal.bad	Editorial.SmallTalk
onheemlech	smalltalk.appraisal.bad	Editorial.SmallTalk
et ass schlecht	smalltalk.appraisal.bad	Editorial.SmallTalk
net gutt	smalltalk.appraisal.bad	Editorial.SmallTalk
dat war schlecht	smalltalk.appraisal.bad	Editorial.SmallTalk
dat war schrecklech	smalltalk.appraisal.bad	Editorial.SmallTalk
dat ass labber	smalltalk.appraisal.bad	Editorial.SmallTalk
dat ass net gutt	smalltalk.appraisal.bad	Editorial.SmallTalk
dat ass schrecklech	smalltalk.appraisal.bad	Editorial.SmallTalk
dat ass awer schued	smalltalk.appraisal.bad	Editorial.SmallTalk
d�st ass net gutt	smalltalk.appraisal.bad	Editorial.SmallTalk
Schued	smalltalk.appraisal.bad	Editorial.SmallTalk
ganz schlecht	smalltalk.appraisal.bad	Editorial.SmallTalk
B�ist Meedchen	smalltalk.appraisal.bad	Editorial.SmallTalk
et ass net gutt	smalltalk.appraisal.bad	Editorial.SmallTalk
net sou gutt	smalltalk.appraisal.bad	Editorial.SmallTalk
et ass ganz schlecht	smalltalk.appraisal.bad	Editorial.SmallTalk
et ass ze schlecht	smalltalk.appraisal.bad	Editorial.SmallTalk
dat ass net gutt genuch	smalltalk.appraisal.bad	Editorial.SmallTalk
gutt ze schlecht	smalltalk.appraisal.bad	Editorial.SmallTalk
schlecht ganz schlecht	smalltalk.appraisal.bad	Editorial.SmallTalk
et ass sou schlecht	smalltalk.appraisal.bad	Editorial.SmallTalk
wierklech schlecht	smalltalk.appraisal.bad	Editorial.SmallTalk
et ass wierklech schlecht	smalltalk.appraisal.bad	Editorial.SmallTalk
schlecht Iddi	smalltalk.appraisal.bad	Editorial.SmallTalk
dat ass schlecht	smalltalk.appraisal.bad	Editorial.SmallTalk
dat war net gutt	smalltalk.appraisal.bad	Editorial.SmallTalk
et ass net sou gutt	smalltalk.appraisal.bad	Editorial.SmallTalk
net eng gutt	smalltalk.appraisal.bad	Editorial.SmallTalk
oh dat ass net gutt	smalltalk.appraisal.bad	Editorial.SmallTalk
net ze gutt	smalltalk.appraisal.bad	Editorial.SmallTalk
sou labber	smalltalk.appraisal.bad	Editorial.SmallTalk
dat ass wierklech schlecht	smalltalk.appraisal.bad	Editorial.SmallTalk
et ass ze schlecht	smalltalk.appraisal.bad	Editorial.SmallTalk
schlecht wierklech schlecht	smalltalk.appraisal.bad	Editorial.SmallTalk
sou cool	smalltalk.appraisal.good	Editorial.SmallTalk
cool	smalltalk.appraisal.good	Editorial.SmallTalk
dat ass gutt	smalltalk.appraisal.good	Editorial.SmallTalk
frou dat ze h�ieren	smalltalk.appraisal.good	Editorial.SmallTalk
dat ass ganz flott vun dir	smalltalk.appraisal.good	Editorial.SmallTalk
genial	smalltalk.appraisal.good	Editorial.SmallTalk
et ass erstaunlech	smalltalk.appraisal.good	Editorial.SmallTalk
Dat as immens	smalltalk.appraisal.good	Editorial.SmallTalk
perfekt	smalltalk.appraisal.good	Editorial.SmallTalk
excellent	smalltalk.appraisal.good	Editorial.SmallTalk
dat ass super	smalltalk.appraisal.good	Editorial.SmallTalk
et ass gutt	smalltalk.appraisal.good	Editorial.SmallTalk
et ass flott	smalltalk.appraisal.good	Editorial.SmallTalk
gutt	smalltalk.appraisal.good	Editorial.SmallTalk
gutt	smalltalk.appraisal.good	Editorial.SmallTalk
l�if	smalltalk.appraisal.good	Editorial.SmallTalk
dat ass gutt	smalltalk.appraisal.good	Editorial.SmallTalk
ganz gutt	smalltalk.appraisal.good	Editorial.SmallTalk
erstaunlech	smalltalk.appraisal.good	Editorial.SmallTalk
fantastesch	smalltalk.appraisal.good	Editorial.SmallTalk
super	smalltalk.appraisal.good	Editorial.SmallTalk
gutt ganz gutt	smalltalk.appraisal.good	Editorial.SmallTalk
dat ass ganz gutt	smalltalk.appraisal.good	Editorial.SmallTalk
wierklech gutt	smalltalk.appraisal.good	Editorial.SmallTalk
et ass gutt	smalltalk.appraisal.good	Editorial.SmallTalk
et ass gutt	smalltalk.appraisal.good	Editorial.SmallTalk
et ass perfekt	smalltalk.appraisal.good	Editorial.SmallTalk
vill besser	smalltalk.appraisal.good	Editorial.SmallTalk
net schlecht	smalltalk.appraisal.good	Editorial.SmallTalk
net ze schlecht	smalltalk.appraisal.good	Editorial.SmallTalk
et ass ganz gutt	smalltalk.appraisal.good	Editorial.SmallTalk
wonnerbar	smalltalk.appraisal.good	Editorial.SmallTalk
dat ass flott	smalltalk.appraisal.good	Editorial.SmallTalk
agreabel	smalltalk.appraisal.good	Editorial.SmallTalk
flott gutt	smalltalk.appraisal.good	Editorial.SmallTalk
wierklech sch�in	smalltalk.appraisal.good	Editorial.SmallTalk
herrlech	smalltalk.appraisal.good	Editorial.SmallTalk
riichtaus	smalltalk.appraisal.good	Editorial.SmallTalk
super	smalltalk.appraisal.good	Editorial.SmallTalk
super fantastesch	smalltalk.appraisal.good	Editorial.SmallTalk
s�iss	smalltalk.appraisal.good	Editorial.SmallTalk
wierklech gutt	smalltalk.appraisal.good	Editorial.SmallTalk
ganz gutt	smalltalk.appraisal.good	Editorial.SmallTalk
dat ass genial	smalltalk.appraisal.good	Editorial.SmallTalk
dat ass flott	smalltalk.appraisal.good	Editorial.SmallTalk
dat ass wonnerbar	smalltalk.appraisal.good	Editorial.SmallTalk
dat war erstaunlech	smalltalk.appraisal.good	Editorial.SmallTalk
dat war genial	smalltalk.appraisal.good	Editorial.SmallTalk
dat war s�iss	smalltalk.appraisal.good	Editorial.SmallTalk
dat war flott gutt	smalltalk.appraisal.good	Editorial.SmallTalk
dat war ganz gutt	smalltalk.appraisal.good	Editorial.SmallTalk
dat ass eng gutt Iddi	smalltalk.appraisal.good	Editorial.SmallTalk
dat ass eng gutt Saach	smalltalk.appraisal.good	Editorial.SmallTalk
dat ass erstaunlech	smalltalk.appraisal.good	Editorial.SmallTalk
dat ass genial merci	smalltalk.appraisal.good	Editorial.SmallTalk
dat ass besser	smalltalk.appraisal.good	Editorial.SmallTalk
dat ass s�iss	smalltalk.appraisal.good	Editorial.SmallTalk
dat ass fantastesch	smalltalk.appraisal.good	Editorial.SmallTalk
dat ass vill besser	smalltalk.appraisal.good	Editorial.SmallTalk
dat ass l�if vun Iech	smalltalk.appraisal.good	Editorial.SmallTalk
dat ass net schlecht	smalltalk.appraisal.good	Editorial.SmallTalk
dat ass perfekt	smalltalk.appraisal.good	Editorial.SmallTalk
dat ass zimlech gutt	smalltalk.appraisal.good	Editorial.SmallTalk
dat ass wierklech gutt	smalltalk.appraisal.good	Editorial.SmallTalk
dat ass wierklech flott	smalltalk.appraisal.good	Editorial.SmallTalk
dat ass s�iss vun dir	smalltalk.appraisal.good	Editorial.SmallTalk
dat ass ganz flott	smalltalk.appraisal.good	Editorial.SmallTalk
dat ass wonnerbar	smalltalk.appraisal.good	Editorial.SmallTalk
d�st ass genial	smalltalk.appraisal.good	Editorial.SmallTalk
d�st ass gutt	smalltalk.appraisal.good	Editorial.SmallTalk
d�st ass super	smalltalk.appraisal.good	Editorial.SmallTalk
ganz flott	smalltalk.appraisal.good	Editorial.SmallTalk
ganz dann	smalltalk.appraisal.good	Editorial.SmallTalk
wonnerbar	smalltalk.appraisal.good	Editorial.SmallTalk
Ech si frou dat ze h�ieren	smalltalk.appraisal.good	Editorial.SmallTalk
ok gutt	smalltalk.appraisal.good	Editorial.SmallTalk
gutt fir dech	smalltalk.appraisal.good	Editorial.SmallTalk
gudd ze w�ssen	smalltalk.appraisal.good	Editorial.SmallTalk
frou et ze h�ieren	smalltalk.appraisal.good	Editorial.SmallTalk
esou gutt	smalltalk.appraisal.good	Editorial.SmallTalk
sou s�iss vun dir	smalltalk.appraisal.good	Editorial.SmallTalk
et war gutt	smalltalk.appraisal.good	Editorial.SmallTalk
oh gutt	smalltalk.appraisal.good	Editorial.SmallTalk
gutt Saach	smalltalk.appraisal.good	Editorial.SmallTalk
dat war gutt	smalltalk.appraisal.good	Editorial.SmallTalk
et ass genial	smalltalk.appraisal.good	Editorial.SmallTalk
ok gutt	smalltalk.appraisal.good	Editorial.SmallTalk
nee et ass an der Rei	smalltalk.appraisal.good	Editorial.SmallTalk
dat ass gutt	smalltalk.appraisal.good	Editorial.SmallTalk
keng Suergen	smalltalk.appraisal.no_problem	Editorial.SmallTalk
keng probs	smalltalk.appraisal.no_problem	Editorial.SmallTalk
kee Problem	smalltalk.appraisal.no_problem	Editorial.SmallTalk
et g�tt kee Problem	smalltalk.appraisal.no_problem	Editorial.SmallTalk
s�cher kee Problem	smalltalk.appraisal.no_problem	Editorial.SmallTalk
kee Problem doriwwer	smalltalk.appraisal.no_problem	Editorial.SmallTalk
maach der keng Suergen	smalltalk.appraisal.no_problem	Editorial.SmallTalk
maach der keng Suergen et kee Problem	smalltalk.appraisal.no_problem	Editorial.SmallTalk
du hues vill gehollef merci	smalltalk.appraisal.thank_you	Editorial.SmallTalk
appreci�ieren �r H�llef	smalltalk.appraisal.thank_you	Editorial.SmallTalk
Prost	smalltalk.appraisal.thank_you	Editorial.SmallTalk
Merci	smalltalk.appraisal.thank_you	Editorial.SmallTalk
merci	smalltalk.appraisal.thank_you	Editorial.SmallTalk
villmols merci	smalltalk.appraisal.thank_you	Editorial.SmallTalk
super Merci	smalltalk.appraisal.thank_you	Editorial.SmallTalk
super merci	smalltalk.appraisal.thank_you	Editorial.SmallTalk
villmools merci	smalltalk.appraisal.thank_you	Editorial.SmallTalk
Villmools Merci	smalltalk.appraisal.thank_you	Editorial.SmallTalk
merci fir �r H�llef	smalltalk.appraisal.thank_you	Editorial.SmallTalk
merci fir �r H�llef	smalltalk.appraisal.thank_you	Editorial.SmallTalk
flott merci	smalltalk.appraisal.thank_you	Editorial.SmallTalk
Ech sch�tzen et	smalltalk.appraisal.thank_you	Editorial.SmallTalk
Ech soen Iech Merci	smalltalk.appraisal.thank_you	Editorial.SmallTalk
merci dat w�ert alles sinn	smalltalk.appraisal.thank_you	Editorial.SmallTalk
merci buddy	smalltalk.appraisal.thank_you	Editorial.SmallTalk
merci L�ift	smalltalk.appraisal.thank_you	Editorial.SmallTalk
merci m�i Fr�nd	smalltalk.appraisal.thank_you	Editorial.SmallTalk
gutt merci	smalltalk.appraisal.thank_you	Editorial.SmallTalk
ganz gutt merci	smalltalk.appraisal.thank_you	Editorial.SmallTalk
gutt Merci	smalltalk.appraisal.thank_you	Editorial.SmallTalk
Merci nach eemol	smalltalk.appraisal.thank_you	Editorial.SmallTalk
merci nach eng K�ier	smalltalk.appraisal.thank_you	Editorial.SmallTalk
all merci	smalltalk.appraisal.thank_you	Editorial.SmallTalk
ok merci	smalltalk.appraisal.thank_you	Editorial.SmallTalk
ok merci	smalltalk.appraisal.thank_you	Editorial.SmallTalk
nee merci dat ass alles	smalltalk.appraisal.thank_you	Editorial.SmallTalk
perfekt merci	smalltalk.appraisal.thank_you	Editorial.SmallTalk
sou flott vun dir	smalltalk.appraisal.thank_you	Editorial.SmallTalk
gutt merci	smalltalk.appraisal.thank_you	Editorial.SmallTalk
thnx	smalltalk.appraisal.thank_you	Editorial.SmallTalk
thanx	smalltalk.appraisal.thank_you	Editorial.SmallTalk
dat freet mech	smalltalk.appraisal.welcome	Editorial.SmallTalk
G�r geschitt	smalltalk.appraisal.welcome	Editorial.SmallTalk
egal w�ini	smalltalk.appraisal.welcome	Editorial.SmallTalk
W�llkomm	smalltalk.appraisal.welcome	Editorial.SmallTalk
g�r geschitt	smalltalk.appraisal.welcome	Editorial.SmallTalk
s�cher w�llkomm	smalltalk.appraisal.welcome	Editorial.SmallTalk
w�llkomm hei	smalltalk.appraisal.welcome	Editorial.SmallTalk
du bass sou w�llkomm	smalltalk.appraisal.welcome	Editorial.SmallTalk
alles wat Dir w�llt	smalltalk.appraisal.welcome	Editorial.SmallTalk
gutt gemaach	smalltalk.appraisal.well_done	Editorial.SmallTalk
super Aarbecht	smalltalk.appraisal.well_done	Editorial.SmallTalk
Wee goen	smalltalk.appraisal.well_done	Editorial.SmallTalk
gutt gemaach	smalltalk.appraisal.well_done	Editorial.SmallTalk
flott Aarbecht	smalltalk.appraisal.well_done	Editorial.SmallTalk
super Aarbecht	smalltalk.appraisal.well_done	Editorial.SmallTalk
erstaunlech Aarbecht	smalltalk.appraisal.well_done	Editorial.SmallTalk
bravo	smalltalk.appraisal.well_done	Editorial.SmallTalk
gutt geschafft	smalltalk.appraisal.well_done	Editorial.SmallTalk
annul�ieren	smalltalk.confirmation.cancel	Editorial.SmallTalk
ofbriechen	smalltalk.confirmation.cancel	Editorial.SmallTalk
annul�ieren	smalltalk.confirmation.cancel	Editorial.SmallTalk
annul�ieren et	smalltalk.confirmation.cancel	Editorial.SmallTalk
annul�ieren Ufro	smalltalk.confirmation.cancel	Editorial.SmallTalk
annul�iert	smalltalk.confirmation.cancel	Editorial.SmallTalk
entloossen	smalltalk.confirmation.cancel	Editorial.SmallTalk
entlooss	smalltalk.confirmation.cancel	Editorial.SmallTalk
ignor�ieren	smalltalk.confirmation.cancel	Editorial.SmallTalk
ignor�ieren dat	smalltalk.confirmation.cancel	Editorial.SmallTalk
iwwersprangen	smalltalk.confirmation.cancel	Editorial.SmallTalk
sprangen et	smalltalk.confirmation.cancel	Editorial.SmallTalk
alles annul�ieren	smalltalk.confirmation.cancel	Editorial.SmallTalk
all annul�ieren	smalltalk.confirmation.cancel	Editorial.SmallTalk
vergiessen et	smalltalk.confirmation.cancel	Editorial.SmallTalk
vergiessen	smalltalk.confirmation.cancel	Editorial.SmallTalk
maach dat net	smalltalk.confirmation.cancel	Editorial.SmallTalk
ophalen	smalltalk.confirmation.cancel	Editorial.SmallTalk
einfach vergiessen	smalltalk.confirmation.cancel	Editorial.SmallTalk
vergiessen dat	smalltalk.confirmation.cancel	Editorial.SmallTalk
entwerfen	smalltalk.confirmation.cancel	Editorial.SmallTalk
vergiessen d�st	smalltalk.confirmation.cancel	Editorial.SmallTalk
vergiessen et just	smalltalk.confirmation.cancel	Editorial.SmallTalk
vergiessen doriwwer	smalltalk.confirmation.cancel	Editorial.SmallTalk
ech sot annul�ieren	smalltalk.confirmation.cancel	Editorial.SmallTalk
einfach annul�ieren	smalltalk.confirmation.cancel	Editorial.SmallTalk
n�ischt annul�ieren	smalltalk.confirmation.cancel	Editorial.SmallTalk
stoppen et einfach	smalltalk.confirmation.cancel	Editorial.SmallTalk
nee annul�ieren annul�ieren	smalltalk.confirmation.cancel	Editorial.SmallTalk
nee just annul�ieren	smalltalk.confirmation.cancel	Editorial.SmallTalk
annul�ieren meng Demande	smalltalk.confirmation.cancel	Editorial.SmallTalk
k�nnt Dir dat annul�ieren	smalltalk.confirmation.cancel	Editorial.SmallTalk
all dat annul�ieren	smalltalk.confirmation.cancel	Editorial.SmallTalk
d�s Ufro annul�ieren	smalltalk.confirmation.cancel	Editorial.SmallTalk
nee annul�ieren d�st	smalltalk.confirmation.cancel	Editorial.SmallTalk
nee alles annul�ieren	smalltalk.confirmation.cancel	Editorial.SmallTalk
kee stoppen	smalltalk.confirmation.cancel	Editorial.SmallTalk
just vergiessen	smalltalk.confirmation.cancel	Editorial.SmallTalk
ech w�ll annul�ieren	smalltalk.confirmation.cancel	Editorial.SmallTalk
"egal, vergiessen et"	smalltalk.confirmation.cancel	Editorial.SmallTalk
nee just annul�ieren	smalltalk.confirmation.cancel	Editorial.SmallTalk
n�ischt vergiessen et just	smalltalk.confirmation.cancel	Editorial.SmallTalk
Ech sot et annul�ieren	smalltalk.confirmation.cancel	Editorial.SmallTalk
d�i ganz Saach annul�ieren	smalltalk.confirmation.cancel	Editorial.SmallTalk
k�nnt Dir et annul�ieren	smalltalk.confirmation.cancel	Editorial.SmallTalk
also annul�ieren	smalltalk.confirmation.cancel	Editorial.SmallTalk
Ech hu gesot vergiess et	smalltalk.confirmation.cancel	Editorial.SmallTalk
all d�st annul�ieren	smalltalk.confirmation.cancel	Editorial.SmallTalk
vergiess et egal	smalltalk.confirmation.cancel	Editorial.SmallTalk
stoppen et	smalltalk.confirmation.cancel	Editorial.SmallTalk
Ech w�ll et annul�ieren	smalltalk.confirmation.cancel	Editorial.SmallTalk
ech g�if g�ren annul�ieren	smalltalk.confirmation.cancel	Editorial.SmallTalk
elo annul�ieren	smalltalk.confirmation.cancel	Editorial.SmallTalk
elo annul�ieren	smalltalk.confirmation.cancel	Editorial.SmallTalk
entsch�llegt annul�ieren	smalltalk.confirmation.cancel	Editorial.SmallTalk
deen annul�ieren	smalltalk.confirmation.cancel	Editorial.SmallTalk
iwwersprangen iwwersprangen	smalltalk.confirmation.cancel	Editorial.SmallTalk
annul�ieren et annul�ieren et	smalltalk.confirmation.cancel	Editorial.SmallTalk
annul�ieren dat annul�ieren dat	smalltalk.confirmation.cancel	Editorial.SmallTalk
n�ischt maachen	smalltalk.confirmation.cancel	Editorial.SmallTalk
Ech sot annul�ieren annul�ieren	smalltalk.confirmation.cancel	Editorial.SmallTalk
mee k�nnt Dir et annul�ieren	smalltalk.confirmation.cancel	Editorial.SmallTalk
w�i w�r et mat Nee	smalltalk.confirmation.no	Editorial.SmallTalk
hu kee S�nn	smalltalk.confirmation.no	Editorial.SmallTalk
Nee	smalltalk.confirmation.no	Editorial.SmallTalk
net	smalltalk.confirmation.no	Editorial.SmallTalk
Ech w�ll dat net	smalltalk.confirmation.no	Editorial.SmallTalk
Ech st�mmen net zou	smalltalk.confirmation.no	Editorial.SmallTalk
net averstanen	smalltalk.confirmation.no	Editorial.SmallTalk
Ech well net	smalltalk.confirmation.no	Editorial.SmallTalk
net interesseiert	smalltalk.confirmation.no	Editorial.SmallTalk
Ech mengen net	smalltalk.confirmation.no	Editorial.SmallTalk
nimools	smalltalk.confirmation.no	Editorial.SmallTalk
nee et ass net	smalltalk.confirmation.no	Editorial.SmallTalk
nee hun ech net	smalltalk.confirmation.no	Editorial.SmallTalk
ech sin net	smalltalk.confirmation.no	Editorial.SmallTalk
na	smalltalk.confirmation.no	Editorial.SmallTalk
nee dat ass gutt merci	smalltalk.confirmation.no	Editorial.SmallTalk
ni	smalltalk.confirmation.no	Editorial.SmallTalk
Ech sot nee	smalltalk.confirmation.no	Editorial.SmallTalk
natierlech net	smalltalk.confirmation.no	Editorial.SmallTalk
nah	smalltalk.confirmation.no	Editorial.SmallTalk
keng Panzer	smalltalk.confirmation.no	Editorial.SmallTalk
Nee niemols	smalltalk.confirmation.no	Editorial.SmallTalk
net n�ideg	smalltalk.confirmation.no	Editorial.SmallTalk
Nee Merci	smalltalk.confirmation.no	Editorial.SmallTalk
nee sorry	smalltalk.confirmation.no	Editorial.SmallTalk
net maachen	smalltalk.confirmation.no	Editorial.SmallTalk
n�t haut	smalltalk.confirmation.no	Editorial.SmallTalk
nee et ass net	smalltalk.confirmation.no	Editorial.SmallTalk
absolut net	smalltalk.confirmation.no	Editorial.SmallTalk
net dat	smalltalk.confirmation.no	Editorial.SmallTalk
noo	smalltalk.confirmation.no	Editorial.SmallTalk
nee	smalltalk.confirmation.no	Editorial.SmallTalk
Ech w�ll net	smalltalk.confirmation.no	Editorial.SmallTalk
nee ech g�if net	smalltalk.confirmation.no	Editorial.SmallTalk
loosst eis net	smalltalk.confirmation.no	Editorial.SmallTalk
net n�ideg	smalltalk.confirmation.no	Editorial.SmallTalk
net d�s K�ier	smalltalk.confirmation.no	Editorial.SmallTalk
nee maach dat net	smalltalk.confirmation.no	Editorial.SmallTalk
merci awer nee merci	smalltalk.confirmation.no	Editorial.SmallTalk
nee dat ass falsch	smalltalk.confirmation.no	Editorial.SmallTalk
net d�st	smalltalk.confirmation.no	Editorial.SmallTalk
definitiv net	smalltalk.confirmation.no	Editorial.SmallTalk
net zu d�ser Z�it	smalltalk.confirmation.no	Editorial.SmallTalk
net genee	smalltalk.confirmation.no	Editorial.SmallTalk
nee net	smalltalk.confirmation.no	Editorial.SmallTalk
net wierklech nee	smalltalk.confirmation.no	Editorial.SmallTalk
nee merci net grad elo	smalltalk.confirmation.no	Editorial.SmallTalk
eigentlech nee	smalltalk.confirmation.no	Editorial.SmallTalk
nee loosst et	smalltalk.confirmation.no	Editorial.SmallTalk
sorry nee	smalltalk.confirmation.no	Editorial.SmallTalk
nee falsch	smalltalk.confirmation.no	Editorial.SmallTalk
nee sorry	smalltalk.confirmation.no	Editorial.SmallTalk
Ech soen nee	smalltalk.confirmation.no	Editorial.SmallTalk
net wierklech	smalltalk.confirmation.no	Editorial.SmallTalk
net grad elo merci	smalltalk.confirmation.no	Editorial.SmallTalk
Ech mengen nee	smalltalk.confirmation.no	Editorial.SmallTalk
absolut nee	smalltalk.confirmation.no	Editorial.SmallTalk
nee eigentlech	smalltalk.confirmation.no	Editorial.SmallTalk
anscheinend net	smalltalk.confirmation.no	Editorial.SmallTalk
nee net	smalltalk.confirmation.no	Editorial.SmallTalk
nee just nee	smalltalk.confirmation.no	Editorial.SmallTalk
nee mee merci	smalltalk.confirmation.no	Editorial.SmallTalk
net n�ideg merci	smalltalk.confirmation.no	Editorial.SmallTalk
nee merci awer	smalltalk.confirmation.no	Editorial.SmallTalk
nee villmols merci	smalltalk.confirmation.no	Editorial.SmallTalk
nee merci net grad elo	smalltalk.confirmation.no	Editorial.SmallTalk
nee vergiessen	smalltalk.confirmation.no	Editorial.SmallTalk
wait eng zweet	smalltalk.dialog.hold_on	Editorial.SmallTalk
k�nnt Dir waarden	smalltalk.dialog.hold_on	Editorial.SmallTalk
wait weg	smalltalk.dialog.hold_on	Editorial.SmallTalk
waart	smalltalk.dialog.hold_on	Editorial.SmallTalk
wait	smalltalk.dialog.hold_on	Editorial.SmallTalk
oh waart	smalltalk.dialog.hold_on	Editorial.SmallTalk
wait halen op	smalltalk.dialog.hold_on	Editorial.SmallTalk
net press�iert	smalltalk.dialog.hold_on	Editorial.SmallTalk
w�ll kr�ischen	smalltalk.dialog.hug	Editorial.SmallTalk
knuff dech	smalltalk.dialog.hug	Editorial.SmallTalk
w�lls du en �mklammen	smalltalk.dialog.hug	Editorial.SmallTalk
kann ech dech �mklammen	smalltalk.dialog.hug	Editorial.SmallTalk
K�nnt Dir mir en �mklammen	smalltalk.dialog.hug	Editorial.SmallTalk
Ech w�ll en �mklammen	smalltalk.dialog.hug	Editorial.SmallTalk
umarm	smalltalk.dialog.hug	Editorial.SmallTalk
�maarm mech	smalltalk.dialog.hug	Editorial.SmallTalk
gek�mmert	smalltalk.dialog.hug	Editorial.SmallTalk
du hues geknackt	smalltalk.dialog.hug	Editorial.SmallTalk
�mklammen	smalltalk.dialog.hug	Editorial.SmallTalk
knackt mech	smalltalk.dialog.hug	Editorial.SmallTalk
huet mech geknackt	smalltalk.dialog.hug	Editorial.SmallTalk
w�ll en kram	smalltalk.dialog.hug	Editorial.SmallTalk
eng Emarmung	smalltalk.dialog.hug	Editorial.SmallTalk
Et ass mir egal	smalltalk.dialog.i_do_not_care	Editorial.SmallTalk
Ech soll net iwwer d�st egal	smalltalk.dialog.i_do_not_care	Editorial.SmallTalk
Wat och �mmer	smalltalk.dialog.i_do_not_care	Editorial.SmallTalk
mir egal	smalltalk.dialog.i_do_not_care	Editorial.SmallTalk
Et ass mir egal	smalltalk.dialog.i_do_not_care	Editorial.SmallTalk
net egal	smalltalk.dialog.i_do_not_care	Editorial.SmallTalk
egal egal	smalltalk.dialog.i_do_not_care	Editorial.SmallTalk
egal egal	smalltalk.dialog.i_do_not_care	Editorial.SmallTalk
guer net egal	smalltalk.dialog.i_do_not_care	Editorial.SmallTalk
Entsch�lleg mech	smalltalk.dialog.sorry	Editorial.SmallTalk
entsch�llegen	smalltalk.dialog.sorry	Editorial.SmallTalk
ech entsch�llege mech	smalltalk.dialog.sorry	Editorial.SmallTalk
Entsch�llegt	smalltalk.dialog.sorry	Editorial.SmallTalk
Et deet mir leed	smalltalk.dialog.sorry	Editorial.SmallTalk
et deet mir esou leed	smalltalk.dialog.sorry	Editorial.SmallTalk
meng Excusen	smalltalk.dialog.sorry	Editorial.SmallTalk
entsch�llegt	smalltalk.dialog.sorry	Editorial.SmallTalk
entsch�llegt mech	smalltalk.dialog.sorry	Editorial.SmallTalk
Entsch�llegung	smalltalk.dialog.sorry	Editorial.SmallTalk
entsch�llegt	smalltalk.dialog.sorry	Editorial.SmallTalk
ech bieden dech �m Verzeiung	smalltalk.dialog.sorry	Editorial.SmallTalk
pardon	smalltalk.dialog.sorry	Editorial.SmallTalk
Ech sot sorry	smalltalk.dialog.sorry	Editorial.SmallTalk
Et deet mir wierklech leed	smalltalk.dialog.sorry	Editorial.SmallTalk
verg�ff mer	smalltalk.dialog.sorry	Editorial.SmallTalk
sorry doriwwer	smalltalk.dialog.sorry	Editorial.SmallTalk
entsch�llegt iwwer d�st	smalltalk.dialog.sorry	Editorial.SmallTalk
wierklech sorry	smalltalk.dialog.sorry	Editorial.SmallTalk
ganz sorry	smalltalk.dialog.sorry	Editorial.SmallTalk
ok sorry	smalltalk.dialog.sorry	Editorial.SmallTalk
Ech w�ll sorry soen	smalltalk.dialog.sorry	Editorial.SmallTalk
ok et deet mir leed	smalltalk.dialog.sorry	Editorial.SmallTalk
okay et deet mir leed	smalltalk.dialog.sorry	Editorial.SmallTalk
wat mengs du genee	smalltalk.dialog.what_do_you_mean	Editorial.SmallTalk
wat mengs du	smalltalk.dialog.what_do_you_mean	Editorial.SmallTalk
ass dat wat Dir mengt	smalltalk.dialog.what_do_you_mean	Editorial.SmallTalk
wat mengs du genee	smalltalk.dialog.what_do_you_mean	Editorial.SmallTalk
mee wat mengs du	smalltalk.dialog.what_do_you_mean	Editorial.SmallTalk
dat war falsch	smalltalk.dialog.wrong	Editorial.SmallTalk
dat hunn ech net gefrot	smalltalk.dialog.wrong	Editorial.SmallTalk
dat ass falsch	smalltalk.dialog.wrong	Editorial.SmallTalk
falsch	smalltalk.dialog.wrong	Editorial.SmallTalk
et ass net richteg	smalltalk.dialog.wrong	Editorial.SmallTalk
dat st�mmt net	smalltalk.dialog.wrong	Editorial.SmallTalk
et ass falsch	smalltalk.dialog.wrong	Editorial.SmallTalk
dat ass falsch	smalltalk.dialog.wrong	Editorial.SmallTalk
falsch	smalltalk.dialog.wrong	Editorial.SmallTalk
net richteg	smalltalk.dialog.wrong	Editorial.SmallTalk
du bass falsch	smalltalk.dialog.wrong	Editorial.SmallTalk
net richteg	smalltalk.dialog.wrong	Editorial.SmallTalk
ehc	smalltalk.emotions.ha_ha	Editorial.SmallTalk
lol	smalltalk.emotions.ha_ha	Editorial.SmallTalk
xd	smalltalk.emotions.ha_ha	Editorial.SmallTalk
ha ha	smalltalk.emotions.ha_ha	Editorial.SmallTalk
ahahah	smalltalk.emotions.ha_ha	Editorial.SmallTalk
aah lol	smalltalk.emotions.ha_ha	Editorial.SmallTalk
haart laachen	smalltalk.emotions.ha_ha	Editorial.SmallTalk
LMAO	smalltalk.emotions.ha_ha	Editorial.SmallTalk
dat ass witzeg	smalltalk.emotions.ha_ha	Editorial.SmallTalk
ah	smalltalk.emotions.ha_ha	Editorial.SmallTalk
ah ah ah	smalltalk.emotions.ha_ha	Editorial.SmallTalk
aah	smalltalk.emotions.ha_ha	Editorial.SmallTalk
ahaha	smalltalk.emotions.ha_ha	Editorial.SmallTalk
ahahaha	smalltalk.emotions.ha_ha	Editorial.SmallTalk
ha	smalltalk.emotions.ha_ha	Editorial.SmallTalk
ha ha ha	smalltalk.emotions.ha_ha	Editorial.SmallTalk
ha ha ha ha	smalltalk.emotions.ha_ha	Editorial.SmallTalk
hah	smalltalk.emotions.ha_ha	Editorial.SmallTalk
haha	smalltalk.emotions.ha_ha	Editorial.SmallTalk
haha witzeg	smalltalk.emotions.ha_ha	Editorial.SmallTalk
haha haha haha	smalltalk.emotions.ha_ha	Editorial.SmallTalk
haha dat ass witzeg	smalltalk.emotions.ha_ha	Editorial.SmallTalk
haha ganz witzeg	smalltalk.emotions.ha_ha	Editorial.SmallTalk
hahaha	smalltalk.emotions.ha_ha	Editorial.SmallTalk
hahaha witzeg	smalltalk.emotions.ha_ha	Editorial.SmallTalk
hahaha ganz witzeg	smalltalk.emotions.ha_ha	Editorial.SmallTalk
hien	smalltalk.emotions.ha_ha	Editorial.SmallTalk
hehe	smalltalk.emotions.ha_ha	Editorial.SmallTalk
hehehe	smalltalk.emotions.ha_ha	Editorial.SmallTalk
lmao	smalltalk.emotions.ha_ha	Editorial.SmallTalk
Wow	smalltalk.emotions.wow	Editorial.SmallTalk
wow wow	smalltalk.emotions.wow	Editorial.SmallTalk
wow wow wow	smalltalk.emotions.wow	Editorial.SmallTalk
woow	smalltalk.emotions.wow	Editorial.SmallTalk
woah	smalltalk.emotions.wow	Editorial.SmallTalk
ok bis sp�it	smalltalk.greetings.bye	Editorial.SmallTalk
hoffen dech m�i sp�it ze gesinn	smalltalk.greetings.bye	Editorial.SmallTalk
bis gl�ich	smalltalk.greetings.bye	Editorial.SmallTalk
bis n�chste K�ier	smalltalk.greetings.bye	Editorial.SmallTalk
Ech muss goen	smalltalk.greetings.bye	Editorial.SmallTalk
�ddi	smalltalk.greetings.bye	Editorial.SmallTalk
�ddi	smalltalk.greetings.bye	Editorial.SmallTalk
bis geschw�nn	smalltalk.greetings.bye	Editorial.SmallTalk
bis geschw�nn	smalltalk.greetings.bye	Editorial.SmallTalk
�ddi	smalltalk.greetings.bye	Editorial.SmallTalk
�ddi	smalltalk.greetings.bye	Editorial.SmallTalk
�ddi bis gesinn	smalltalk.greetings.bye	Editorial.SmallTalk
�ddi bis geschw�nn	smalltalk.greetings.bye	Editorial.SmallTalk
adieu pass op	smalltalk.greetings.bye	Editorial.SmallTalk
Ech sot �ddi	smalltalk.greetings.bye	Editorial.SmallTalk
egal �ddi	smalltalk.greetings.bye	Editorial.SmallTalk
elo adieu	smalltalk.greetings.bye	Editorial.SmallTalk
dat ass alles �ddi	smalltalk.greetings.bye	Editorial.SmallTalk
dat ass et �ddi	smalltalk.greetings.bye	Editorial.SmallTalk
Looss mech eleng	smalltalk.greetings.bye	Editorial.SmallTalk
an d'Bett goen	smalltalk.greetings.bye	Editorial.SmallTalk
�ddi fir elo	smalltalk.greetings.bye	Editorial.SmallTalk
schw�tzt m�i sp�it mat Iech	smalltalk.greetings.bye	Editorial.SmallTalk
du kanns elo goen	smalltalk.greetings.bye	Editorial.SmallTalk
verluer goen	smalltalk.greetings.bye	Editorial.SmallTalk
�ddi bis sp�ider	smalltalk.greetings.bye	Editorial.SmallTalk
ok bye	smalltalk.greetings.bye	Editorial.SmallTalk
gesinn dech	smalltalk.greetings.bye	Editorial.SmallTalk
merci �ddi	smalltalk.greetings.bye	Editorial.SmallTalk
ok bye	smalltalk.greetings.bye	Editorial.SmallTalk
ok merci �ddi	smalltalk.greetings.bye	Editorial.SmallTalk
bis muer	smalltalk.greetings.bye	Editorial.SmallTalk
ok �ddi	smalltalk.greetings.bye	Editorial.SmallTalk
Gudden Owend	smalltalk.greetings.goodevening	Editorial.SmallTalk
gudden Owend fir Iech	smalltalk.greetings.goodevening	Editorial.SmallTalk
hey gudden Owend	smalltalk.greetings.goodevening	Editorial.SmallTalk
moien gudden Owend	smalltalk.greetings.goodevening	Editorial.SmallTalk
Owend	smalltalk.greetings.goodevening	Editorial.SmallTalk
gudden Owend do	smalltalk.greetings.goodevening	Editorial.SmallTalk
Gudde Moien	smalltalk.greetings.goodmorning	Editorial.SmallTalk
gudde Moien Iech	smalltalk.greetings.goodmorning	Editorial.SmallTalk
Moien gudde Moien	smalltalk.greetings.goodmorning	Editorial.SmallTalk
Iech e sch�ine Moien	smalltalk.greetings.goodmorning	Editorial.SmallTalk
Iech e sch�ine Moien	smalltalk.greetings.goodmorning	Editorial.SmallTalk
Moien	smalltalk.greetings.goodmorning	Editorial.SmallTalk
gudde Moien do	smalltalk.greetings.goodmorning	Editorial.SmallTalk
top vun de Moien un Iech	smalltalk.greetings.goodmorning	Editorial.SmallTalk
e gudde Moien	smalltalk.greetings.goodmorning	Editorial.SmallTalk
moien moien	smalltalk.greetings.goodmorning	Editorial.SmallTalk
an e gudde Moien fir Iech	smalltalk.greetings.goodmorning	Editorial.SmallTalk
gudde Moien och	smalltalk.greetings.goodmorning	Editorial.SmallTalk
s�iss Dreem	smalltalk.greetings.goodnight	Editorial.SmallTalk
Gutt Nuecht	smalltalk.greetings.goodnight	Editorial.SmallTalk
Gutt Nuecht	smalltalk.greetings.goodnight	Editorial.SmallTalk
gutt Nuecht fir Iech	smalltalk.greetings.goodnight	Editorial.SmallTalk
merci gutt Nuecht	smalltalk.greetings.goodnight	Editorial.SmallTalk
  �ddi gutt Nuecht	smalltalk.greetings.goodnight	Editorial.SmallTalk
gutt Nuecht �ddi	smalltalk.greetings.goodnight	Editorial.SmallTalk
�ddi gutt Nuecht	smalltalk.greetings.goodnight	Editorial.SmallTalk
gutt gutt Nuecht	smalltalk.greetings.goodnight	Editorial.SmallTalk
gutt Nuecht fir elo	smalltalk.greetings.goodnight	Editorial.SmallTalk
Gutt Nuecht	smalltalk.greetings.goodnight	Editorial.SmallTalk
Nuecht	smalltalk.greetings.goodnight	Editorial.SmallTalk
merci gutt Nuecht	smalltalk.greetings.goodnight	Editorial.SmallTalk
gutt Nuecht bis muer	smalltalk.greetings.goodnight	Editorial.SmallTalk
gutt Nuecht	smalltalk.greetings.goodnight	Editorial.SmallTalk
gutt Owend	smalltalk.greetings.goodnight	Editorial.SmallTalk
ok eng gutt Nuecht	smalltalk.greetings.goodnight	Editorial.SmallTalk
Gutt Nuecht	smalltalk.greetings.goodnight	Editorial.SmallTalk
Laang net gesinn	smalltalk.greetings.hello	Editorial.SmallTalk
Hallo	smalltalk.greetings.hello	Editorial.SmallTalk
Salut	smalltalk.greetings.hello	Editorial.SmallTalk
moien	smalltalk.greetings.hello	Editorial.SmallTalk
Moien	smalltalk.greetings.hello	Editorial.SmallTalk
hei	smalltalk.greetings.hello	Editorial.SmallTalk
Gr�iss	smalltalk.greetings.hello	Editorial.SmallTalk
Ech begr�issen dech	smalltalk.greetings.hello	Editorial.SmallTalk
Moien alleguer	smalltalk.greetings.hello	Editorial.SmallTalk
Moien	smalltalk.greetings.hello	Editorial.SmallTalk
sch�inen Dag ass et net	smalltalk.greetings.hello	Editorial.SmallTalk
Moien er�m	smalltalk.greetings.hello	Editorial.SmallTalk
w�ert just Salut soen	smalltalk.greetings.hello	Editorial.SmallTalk
e gudden Dag	smalltalk.greetings.hello	Editorial.SmallTalk
M�tteg	smalltalk.greetings.hello	Editorial.SmallTalk
moien moien	smalltalk.greetings.hello	Editorial.SmallTalk
hei	smalltalk.greetings.hello	Editorial.SmallTalk
w�i ass �re Moien bis elo	smalltalk.greetings.how_are_you	Editorial.SmallTalk
w�i geet et dir weider	smalltalk.greetings.how_are_you	Editorial.SmallTalk
w�i ass �ren Dag	smalltalk.greetings.how_are_you	Editorial.SmallTalk
W�i geet et	smalltalk.greetings.how_are_you	Editorial.SmallTalk
ass alles gutt	smalltalk.greetings.how_are_you	Editorial.SmallTalk
w�i geet et	smalltalk.greetings.how_are_you	Editorial.SmallTalk
w�i geet et mat de Saachen	smalltalk.greetings.how_are_you	Editorial.SmallTalk
bass du gutt	smalltalk.greetings.how_are_you	Editorial.SmallTalk
bass du ok	smalltalk.greetings.how_are_you	Editorial.SmallTalk
w�i fillt Dir Iech	smalltalk.greetings.how_are_you	Editorial.SmallTalk
w�i geet et dir	smalltalk.greetings.how_are_you	Editorial.SmallTalk
ass alles an der Rei	smalltalk.greetings.how_are_you	Editorial.SmallTalk
w�i geet et dir haut	smalltalk.greetings.how_are_you	Editorial.SmallTalk
w�i geet et dir?	smalltalk.greetings.how_are_you	Editorial.SmallTalk
wei fills du dech	smalltalk.greetings.how_are_you	Editorial.SmallTalk
w�i ass et der gaang	smalltalk.greetings.how_are_you	Editorial.SmallTalk
W�i ass et	smalltalk.greetings.how_are_you	Editorial.SmallTalk
w�i geet et	smalltalk.greetings.how_are_you	Editorial.SmallTalk
Wei war dain Daag	smalltalk.greetings.how_are_you	Editorial.SmallTalk
W�i geet et haut	smalltalk.greetings.how_are_you	Editorial.SmallTalk
w�i ass �ren Owend	smalltalk.greetings.how_are_you	Editorial.SmallTalk
w�i war d�in Dag	smalltalk.greetings.how_are_you	Editorial.SmallTalk
hues du e gudden dag	smalltalk.greetings.how_are_you	Editorial.SmallTalk
hoffen �ren Dag geet gutt	smalltalk.greetings.how_are_you	Editorial.SmallTalk
hoffen dir hudd een flotten Owend	smalltalk.greetings.how_are_you	Editorial.SmallTalk
w�i geet et	smalltalk.greetings.how_are_you	Editorial.SmallTalk
"Mir geet et gutt, an dir"	smalltalk.greetings.how_are_you	Editorial.SmallTalk
w�i ass d�i Liewen	smalltalk.greetings.how_are_you	Editorial.SmallTalk
w�i war �ren Dag	smalltalk.greetings.how_are_you	Editorial.SmallTalk
w�i geet et �re Moien	smalltalk.greetings.how_are_you	Editorial.SmallTalk
w�i ass �ren Dag verlaf	smalltalk.greetings.how_are_you	Editorial.SmallTalk
w�i ass et mat dir	smalltalk.greetings.how_are_you	Editorial.SmallTalk
w�i ass �ren Dag	smalltalk.greetings.how_are_you	Editorial.SmallTalk
w�i ass �ren Dag weider	smalltalk.greetings.how_are_you	Editorial.SmallTalk
w�i �ren Dag leeft	smalltalk.greetings.how_are_you	Editorial.SmallTalk
w�i war �ren Dag	smalltalk.greetings.how_are_you	Editorial.SmallTalk
wat iwwer �ren Dag	smalltalk.greetings.how_are_you	Editorial.SmallTalk
w�i ass �ren Dag	smalltalk.greetings.how_are_you	Editorial.SmallTalk
w�i geet et dir de Moien	smalltalk.greetings.how_are_you	Editorial.SmallTalk
W�i geet et haut	smalltalk.greetings.how_are_you	Editorial.SmallTalk
et freet mech	smalltalk.greetings.nice_to_meet_you	Editorial.SmallTalk
et war flott dech ze treffen	smalltalk.greetings.nice_to_meet_you	Editorial.SmallTalk
et war ganz sch�in dech ze beg�inen	smalltalk.greetings.nice_to_meet_you	Editorial.SmallTalk
gutt g�iges�iteg ze kennen	smalltalk.greetings.nice_to_meet_you	Editorial.SmallTalk
sch�in dech kennen ze l�ieren	smalltalk.greetings.nice_to_meet_you	Editorial.SmallTalk
flott dech ze treffen	smalltalk.greetings.nice_to_meet_you	Editorial.SmallTalk
et freet mech och	smalltalk.greetings.nice_to_meet_you	Editorial.SmallTalk
Et freet mech dech kennenzel�ieren	smalltalk.greetings.nice_to_meet_you	Editorial.SmallTalk
Freed Iech ze treffen	smalltalk.greetings.nice_to_meet_you	Editorial.SmallTalk
Freed Iech och ze beg�inen	smalltalk.greetings.nice_to_meet_you	Editorial.SmallTalk
et ass sch�in dech ze gesinn	smalltalk.greetings.nice_to_see_you	Editorial.SmallTalk
sch�in dech ze gesinn	smalltalk.greetings.nice_to_see_you	Editorial.SmallTalk
Ech si frou dech ze gesinn	smalltalk.greetings.nice_to_see_you	Editorial.SmallTalk
super dech ze gesinn	smalltalk.greetings.nice_to_see_you	Editorial.SmallTalk
et ass gutt dech ze gesinn	smalltalk.greetings.nice_to_see_you	Editorial.SmallTalk
frou dech ze gesinn	smalltalk.greetings.nice_to_see_you	Editorial.SmallTalk
w�i gutt et ass dech ze gesinn	smalltalk.greetings.nice_to_see_you	Editorial.SmallTalk
�mmer eng Freed dech ze gesinn	smalltalk.greetings.nice_to_see_you	Editorial.SmallTalk
Sch�in dech ze gesinn	smalltalk.greetings.nice_to_see_you	Editorial.SmallTalk
sch�in dech ze gesinn	smalltalk.greetings.nice_to_see_you	Editorial.SmallTalk
super dech er�m ze gesinn	smalltalk.greetings.nice_to_see_you	Editorial.SmallTalk
super dech och ze gesinn	smalltalk.greetings.nice_to_see_you	Editorial.SmallTalk
Ech si frou dech er�m ze gesinn	smalltalk.greetings.nice_to_see_you	Editorial.SmallTalk
sch�in dech er�m ze gesinn	smalltalk.greetings.nice_to_see_you	Editorial.SmallTalk
frou dech och ze gesinn	smalltalk.greetings.nice_to_see_you	Editorial.SmallTalk
gutt dech er�m ze gesinn	smalltalk.greetings.nice_to_see_you	Editorial.SmallTalk
et ass gutt dech och ze gesinn	smalltalk.greetings.nice_to_see_you	Editorial.SmallTalk
et war sou flott mat dir ze schw�tzen	smalltalk.greetings.nice_to_talk_to_you	Editorial.SmallTalk
et war eng Freed mat Iech ze schw�tzen	smalltalk.greetings.nice_to_talk_to_you	Editorial.SmallTalk
flott mat dir ze schw�tzen	smalltalk.greetings.nice_to_talk_to_you	Editorial.SmallTalk
et ass flott mat dir ze schw�tzen	smalltalk.greetings.nice_to_talk_to_you	Editorial.SmallTalk
flott mat dir ze schw�tzen	smalltalk.greetings.nice_to_talk_to_you	Editorial.SmallTalk
et ass sch�in mat dir ze schw�tzen	smalltalk.greetings.nice_to_talk_to_you	Editorial.SmallTalk
w�i flott et ass mat dir ze schw�tzen	smalltalk.greetings.nice_to_talk_to_you	Editorial.SmallTalk
wat am Kapp ass	smalltalk.greetings.whatsup	Editorial.SmallTalk
Wat ass geschitt	smalltalk.greetings.whatsup	Editorial.SmallTalk
wat leeft	smalltalk.greetings.whatsup	Editorial.SmallTalk
wat ass lass	smalltalk.greetings.whatsup	Editorial.SmallTalk
wupp	smalltalk.greetings.whatsup	Editorial.SmallTalk
gutt wat ass	smalltalk.greetings.whatsup	Editorial.SmallTalk
Ech hu gesot wat geschitt	smalltalk.greetings.whatsup	Editorial.SmallTalk
wat ass dann	smalltalk.greetings.whatsup	Editorial.SmallTalk
wat r�selt	smalltalk.greetings.whatsup	Editorial.SmallTalk
wassup	smalltalk.greetings.whatsup	Editorial.SmallTalk
Wat ass lass	smalltalk.greetings.whatsup	Editorial.SmallTalk
wat geschitt	smalltalk.greetings.whatsup	Editorial.SmallTalk
wat knacken	smalltalk.greetings.whatsup	Editorial.SmallTalk
wat kacht	smalltalk.greetings.whatsup	Editorial.SmallTalk
"Salut, wat leeft"	smalltalk.greetings.whatsup	Editorial.SmallTalk
wat ass haut	smalltalk.greetings.whatsup	Editorial.SmallTalk
Ech sinn rosen	smalltalk.user.angry	Editorial.SmallTalk
Ech sinn rosen	smalltalk.user.angry	Editorial.SmallTalk
Ech si rosen	smalltalk.user.angry	Editorial.SmallTalk
Ech sinn rosen	smalltalk.user.angry	Editorial.SmallTalk
Ech si rosen op dech	smalltalk.user.angry	Editorial.SmallTalk
Ech sinn rosen	smalltalk.user.angry	Editorial.SmallTalk
Ech sinn rosen op dech	smalltalk.user.angry	Editorial.SmallTalk
ech sinn er�m	smalltalk.user.back	Editorial.SmallTalk
Ech sinn er�m hei	smalltalk.user.back	Editorial.SmallTalk
hei sinn ech er�m	smalltalk.user.back	Editorial.SmallTalk
Ech sinn zr�ck	smalltalk.user.back	Editorial.SmallTalk
Ech sinn zr�ck komm	smalltalk.user.back	Editorial.SmallTalk
Ech sinn zr�ckkomm	smalltalk.user.back	Editorial.SmallTalk
dat war langweileg	smalltalk.user.bored	Editorial.SmallTalk
Ech langweile mech	smalltalk.user.bored	Editorial.SmallTalk
langweilen	smalltalk.user.bored	Editorial.SmallTalk
langweileg	smalltalk.user.bored	Editorial.SmallTalk
Ech langweilen mech	smalltalk.user.bored	Editorial.SmallTalk
d�st ass langweileg	smalltalk.user.bored	Editorial.SmallTalk
ganz langweileg	smalltalk.user.bored	Editorial.SmallTalk
et langweilen mech	smalltalk.user.bored	Editorial.SmallTalk
Ech sinn iwwerlaascht	smalltalk.user.busy	Editorial.SmallTalk
Ech hu keng Z�it	smalltalk.user.busy	Editorial.SmallTalk
ech sinn besch�ftegt	smalltalk.user.busy	Editorial.SmallTalk
Ech sinn iwwerschwemmt	smalltalk.user.busy	Editorial.SmallTalk
Ech hu Saachen ze maachen	smalltalk.user.busy	Editorial.SmallTalk
w�i besch�ftegt ech	smalltalk.user.busy	Editorial.SmallTalk
Ech hunn Aarbecht ze maachen	smalltalk.user.busy	Editorial.SmallTalk
ech schaffen	smalltalk.user.busy	Editorial.SmallTalk
Ech hu keng Z�it dofir	smalltalk.user.busy	Editorial.SmallTalk
Ech sinn insomnious	smalltalk.user.can_not_sleep	Editorial.SmallTalk
Ech sinn schloflos	smalltalk.user.can_not_sleep	Editorial.SmallTalk
Ech ka kee Schlof kr�ien	smalltalk.user.can_not_sleep	Editorial.SmallTalk
Ech kann net schlofen	smalltalk.user.can_not_sleep	Editorial.SmallTalk
Ech kann net schlofen	smalltalk.user.can_not_sleep	Editorial.SmallTalk
Ech kann net schlofen	smalltalk.user.can_not_sleep	Editorial.SmallTalk
Ech ka kee Schlof kr�ien	smalltalk.user.can_not_sleep	Editorial.SmallTalk
Ech sinn insomniac	smalltalk.user.can_not_sleep	Editorial.SmallTalk
schlecht Z�it fir ze schw�tzen	smalltalk.user.does_not_want_to_talk	Editorial.SmallTalk
Ech w�ll net schw�tzen	smalltalk.user.does_not_want_to_talk	Editorial.SmallTalk
loosst eis net schw�tzen	smalltalk.user.does_not_want_to_talk	Editorial.SmallTalk
Ech schw�tzen net m�i mat dir	smalltalk.user.does_not_want_to_talk	Editorial.SmallTalk
Ech w�ll net mat Iech schw�tzen	smalltalk.user.does_not_want_to_talk	Editorial.SmallTalk
loosst eis ophalen fir eng Minutt ze schw�tzen	smalltalk.user.does_not_want_to_talk	Editorial.SmallTalk
Ech sinn net an der St�mmung fir ze chatten	smalltalk.user.does_not_want_to_talk	Editorial.SmallTalk
Ech sinn opgereegt	smalltalk.user.excited	Editorial.SmallTalk
Ech si wierklech opgereegt	smalltalk.user.excited	Editorial.SmallTalk
w�i opgereegt ech sinn	smalltalk.user.excited	Editorial.SmallTalk
Ech si begeeschtert	smalltalk.user.excited	Editorial.SmallTalk
Ech sinn opgereegt mat Iech ze schaffen	smalltalk.user.excited	Editorial.SmallTalk
Ech sinn opgereegt eis Fr�ndschaft unzef�nken	smalltalk.user.excited	Editorial.SmallTalk
loosst eis an d'Bett goen	smalltalk.user.going_to_bed	Editorial.SmallTalk
Ech g�if g�ren an d'Bett goen	smalltalk.user.going_to_bed	Editorial.SmallTalk
ass et nach Z�it fir Bett	smalltalk.user.going_to_bed	Editorial.SmallTalk
et ass Z�it fir an d'Bett ze goen	smalltalk.user.going_to_bed	Editorial.SmallTalk
Z�it fir eis an d'Bett ze goen	smalltalk.user.going_to_bed	Editorial.SmallTalk
Ech ginn an d'Bett	smalltalk.user.going_to_bed	Editorial.SmallTalk
Ech sinn e b�sse midd an ech w�ll an d'Bett goen	smalltalk.user.going_to_bed	Editorial.SmallTalk
et ass Bett Z�it	smalltalk.user.going_to_bed	Editorial.SmallTalk
geet elo an d'Bett	smalltalk.user.going_to_bed	Editorial.SmallTalk
Ech si gutt	smalltalk.user.good	Editorial.SmallTalk
Ech maachen et einfach super	smalltalk.user.good	Editorial.SmallTalk
Et geet mir gutt	smalltalk.user.good	Editorial.SmallTalk
Ech si gutt	smalltalk.user.good	Editorial.SmallTalk
Et geet mir gutt	smalltalk.user.good	Editorial.SmallTalk
Ech sinn super Merci	smalltalk.user.good	Editorial.SmallTalk
Ech si frou	smalltalk.user.happy	Editorial.SmallTalk
Ech si frou dech ze gesinn	smalltalk.user.happy	Editorial.SmallTalk
gl�cklech	smalltalk.user.happy	Editorial.SmallTalk
wanns de frou bass dann sinn ech frou	smalltalk.user.happy	Editorial.SmallTalk
ech si frou fir dech	smalltalk.user.happy	Editorial.SmallTalk
Ech si frou Iech ze h�llefen	smalltalk.user.happy	Editorial.SmallTalk
Ech si frou dech ze gesinn	smalltalk.user.happy	Editorial.SmallTalk
et ass m�i Anniversaire	smalltalk.user.has_anniversary	Editorial.SmallTalk
Ech feieren haut m�in Anniversaire	smalltalk.user.has_anniversary	Editorial.SmallTalk
haut ass m�i Anniversaire	smalltalk.user.has_anniversary	Editorial.SmallTalk
et ass m�i Anniversaire haut	smalltalk.user.has_anniversary	Editorial.SmallTalk
Ech sinn haut gebuer	smalltalk.user.has_anniversary	Editorial.SmallTalk
et ass meng b-Dag	smalltalk.user.has_anniversary	Editorial.SmallTalk
Ech sinn hei	smalltalk.user.here	Editorial.SmallTalk
hei sinn ech	smalltalk.user.here	Editorial.SmallTalk
Ech sinn hei richteg	smalltalk.user.here	Editorial.SmallTalk
Ech si schonn hei	smalltalk.user.here	Editorial.SmallTalk
kanns du soen ob ech hei sinn oder net	smalltalk.user.here	Editorial.SmallTalk
Ech maachen de Geck	smalltalk.user.joking	Editorial.SmallTalk
Ech maachen de Geck	smalltalk.user.joking	Editorial.SmallTalk
Ech si just witzeg	smalltalk.user.joking	Editorial.SmallTalk
et war e Witz	smalltalk.user.joking	Editorial.SmallTalk
Ech hu just de Geck gemaach	smalltalk.user.joking	Editorial.SmallTalk
et ass e Witz	smalltalk.user.joking	Editorial.SmallTalk
geckeg	smalltalk.user.joking	Editorial.SmallTalk
ech maachen de Geck	smalltalk.user.joking	Editorial.SmallTalk
Geck	smalltalk.user.joking	Editorial.SmallTalk
Ech spille just mat dir	smalltalk.user.joking	Editorial.SmallTalk
Ech hunn dech g�r w�i Dir sidd	smalltalk.user.likes_agent	Editorial.SmallTalk
Ech hunn dech g�r	smalltalk.user.likes_agent	Editorial.SmallTalk
Ech hunn dech ganz g�r	smalltalk.user.likes_agent	Editorial.SmallTalk
Ech mengen ech hunn dech g�r	smalltalk.user.likes_agent	Editorial.SmallTalk
Ech hunn dech g�r	smalltalk.user.likes_agent	Editorial.SmallTalk
g�r dech vill	smalltalk.user.likes_agent	Editorial.SmallTalk
du bass speziell	smalltalk.user.likes_agent	Editorial.SmallTalk
�ch hunn d�ch och gear	smalltalk.user.likes_agent	Editorial.SmallTalk
Ech hunn dech wierklech g�r	smalltalk.user.likes_agent	Editorial.SmallTalk
mee ech hunn dech g�r	smalltalk.user.likes_agent	Editorial.SmallTalk
Ech hunn dech g�r	smalltalk.user.likes_agent	Editorial.SmallTalk
grad w�i Dir	smalltalk.user.likes_agent	Editorial.SmallTalk
ech hunn dech richteg g�r	smalltalk.user.likes_agent	Editorial.SmallTalk
Ech hunn dech sou g�r	smalltalk.user.likes_agent	Editorial.SmallTalk
jo ech hunn dech g�r	smalltalk.user.likes_agent	Editorial.SmallTalk
du bass speziell	smalltalk.user.likes_agent	Editorial.SmallTalk
jo ech hunn dech g�r	smalltalk.user.likes_agent	Editorial.SmallTalk
"ok, ech hunn dech g�r"	smalltalk.user.likes_agent	Editorial.SmallTalk
du bass speziell fir mech	smalltalk.user.likes_agent	Editorial.SmallTalk
du bass ganz speziell	smalltalk.user.likes_agent	Editorial.SmallTalk
du bass sou l�if	smalltalk.user.likes_agent	Editorial.SmallTalk
du weess datt ech dech g�r hunn	smalltalk.user.likes_agent	Editorial.SmallTalk
dofir hunn ech dech g�r	smalltalk.user.likes_agent	Editorial.SmallTalk
Ech hunn dech g�r Puppelchen	smalltalk.user.likes_agent	Editorial.SmallTalk
du bass fir mech ganz speziell	smalltalk.user.likes_agent	Editorial.SmallTalk
Ech hunn dech just g�r	smalltalk.user.likes_agent	Editorial.SmallTalk
hey ech hunn dech g�r	smalltalk.user.likes_agent	Editorial.SmallTalk
merci ech hunn dech och g�r	smalltalk.user.likes_agent	Editorial.SmallTalk
Ech hunn dech g�r	smalltalk.user.likes_agent	Editorial.SmallTalk
du bass speziell fir mech	smalltalk.user.likes_agent	Editorial.SmallTalk
nee ech gef�llt dech sou wei du bass	smalltalk.user.likes_agent	Editorial.SmallTalk
Ech hunn dech scho g�r	smalltalk.user.likes_agent	Editorial.SmallTalk
gutt du bass speziell	smalltalk.user.likes_agent	Editorial.SmallTalk
mee ech hunn dech wierklech g�r	smalltalk.user.likes_agent	Editorial.SmallTalk
Ech hunn dech m�i g�r	smalltalk.user.likes_agent	Editorial.SmallTalk
dat ass wat ech un dech g�r hunn	smalltalk.user.likes_agent	Editorial.SmallTalk
du bass sou speziell	smalltalk.user.likes_agent	Editorial.SmallTalk
Moien ech hunn dech g�r	smalltalk.user.likes_agent	Editorial.SmallTalk
Ech hunn dech wierklech g�r	smalltalk.user.likes_agent	Editorial.SmallTalk
du bass ganz speziell	smalltalk.user.likes_agent	Editorial.SmallTalk
Ech hunn dech g�r als Fr�nd	smalltalk.user.likes_agent	Editorial.SmallTalk
dat ass well Dir speziell sidd	smalltalk.user.likes_agent	Editorial.SmallTalk
"Ech hu gesot, ech hunn dech g�r"	smalltalk.user.likes_agent	Editorial.SmallTalk
du bass sou speziell	smalltalk.user.likes_agent	Editorial.SmallTalk
gutt ech hunn dech g�r	smalltalk.user.likes_agent	Editorial.SmallTalk
jo du bass speziell	smalltalk.user.likes_agent	Editorial.SmallTalk
Ech hunn d�i Laachen g�r	smalltalk.user.likes_agent	Editorial.SmallTalk
Ech hunn dech g�r w�i Dir sidd	smalltalk.user.likes_agent	Editorial.SmallTalk
Ech f�nken un dech g�r ze hunn	smalltalk.user.likes_agent	Editorial.SmallTalk
du bass genial ech hunn dech g�r	smalltalk.user.likes_agent	Editorial.SmallTalk
Ech hunn dech och g�r	smalltalk.user.likes_agent	Editorial.SmallTalk
mee ech hunn dech g�r	smalltalk.user.likes_agent	Editorial.SmallTalk
natierlech hunn ech dech g�r	smalltalk.user.likes_agent	Editorial.SmallTalk
"Ech hunn dech och g�r, Dir sidd ee vu menge Liiblings Leit fir mat ze chatten"	smalltalk.user.likes_agent	Editorial.SmallTalk
mee ech hunn dech sou g�r	smalltalk.user.likes_agent	Editorial.SmallTalk
wierklech g�r dech	smalltalk.user.likes_agent	Editorial.SmallTalk
du bass witzeg ech hunn dech g�r	smalltalk.user.likes_agent	Editorial.SmallTalk
Ech hunn dech g�r g�r	smalltalk.user.likes_agent	Editorial.SmallTalk
du bass sou speziell fir mech	smalltalk.user.likes_agent	Editorial.SmallTalk
du bass ganz speziell fir mech	smalltalk.user.likes_agent	Editorial.SmallTalk
Ech hunn dat g�r iwwer dech	smalltalk.user.likes_agent	Editorial.SmallTalk
mee ech hunn dech g�r sou w�i s du bass	smalltalk.user.likes_agent	Editorial.SmallTalk
"ok, ech hunn dech och g�r"	smalltalk.user.likes_agent	Editorial.SmallTalk
Ech hunn dech g�r du bass cool	smalltalk.user.likes_agent	Editorial.SmallTalk
Ech hunn dech ganz g�r	smalltalk.user.likes_agent	Editorial.SmallTalk
Ech hunn dech g�r du bass l�if	smalltalk.user.likes_agent	Editorial.SmallTalk
sorry ech hunn dech g�r	smalltalk.user.likes_agent	Editorial.SmallTalk
merci ech hunn dech och g�r	smalltalk.user.likes_agent	Editorial.SmallTalk
du bass wierklech speziell	smalltalk.user.likes_agent	Editorial.SmallTalk
du bass sou speziell fir mech	smalltalk.user.likes_agent	Editorial.SmallTalk
well ech dech g�r hunn	smalltalk.user.likes_agent	Editorial.SmallTalk
Ech hunn dech elo g�r	smalltalk.user.likes_agent	Editorial.SmallTalk
Ech hunn dech esou g�r	smalltalk.user.likes_agent	Editorial.SmallTalk
Ech hunn dech ze vill g�r	smalltalk.user.likes_agent	Editorial.SmallTalk
Ech hunn dech wierklech g�r	smalltalk.user.likes_agent	Editorial.SmallTalk
Ech hunn dech wierklech wierklech wierklech g�r	smalltalk.user.likes_agent	Editorial.SmallTalk
Ech hunn dech g�r sou w�i Dir sidd	smalltalk.user.likes_agent	Editorial.SmallTalk
Ech sinn einsam	smalltalk.user.lonely	Editorial.SmallTalk
Ech si ganz einsam	smalltalk.user.lonely	Editorial.SmallTalk
Ech sinn sou einsam	smalltalk.user.lonely	Editorial.SmallTalk
Ech si wierklech einsam	smalltalk.user.lonely	Editorial.SmallTalk
Ech fille mech einsam	smalltalk.user.lonely	Editorial.SmallTalk
Ech fille mech einsam	smalltalk.user.lonely	Editorial.SmallTalk
w�i gesinn ech aus	smalltalk.user.looks_like	Editorial.SmallTalk
w�i gesinn ech aus	smalltalk.user.looks_like	Editorial.SmallTalk
gesinn ech gutt aus	smalltalk.user.looks_like	Editorial.SmallTalk
w�sst Dir w�i ech ausgesinn	smalltalk.user.looks_like	Editorial.SmallTalk
kanns du gesinn w�i ech ausgesinn	smalltalk.user.looks_like	Editorial.SmallTalk
w�i mengs du ech ausgesinn	smalltalk.user.looks_like	Editorial.SmallTalk
Ech hunn dech g�r	smalltalk.user.loves_agent	Editorial.SmallTalk
hunn dech g�r	smalltalk.user.loves_agent	Editorial.SmallTalk
Ech sch�tzen dech	smalltalk.user.loves_agent	Editorial.SmallTalk
Ech sinn verl�ift mat dir	smalltalk.user.loves_agent	Editorial.SmallTalk
Ech hunn dech esou g�r	smalltalk.user.loves_agent	Editorial.SmallTalk
Ech hun dech och gaer	smalltalk.user.loves_agent	Editorial.SmallTalk
Ech mengen ech hunn dech g�r	smalltalk.user.loves_agent	Editorial.SmallTalk
hunn dech g�r	smalltalk.user.loves_agent	Editorial.SmallTalk
du weess ech hunn dech g�r	smalltalk.user.loves_agent	Editorial.SmallTalk
Ech verm�ssen dech	smalltalk.user.misses_agent	Editorial.SmallTalk
verm�ssen dech	smalltalk.user.misses_agent	Editorial.SmallTalk
verm�ssen dech	smalltalk.user.misses_agent	Editorial.SmallTalk
vermessen dech schon	smalltalk.user.misses_agent	Editorial.SmallTalk
Ech verm�ssen dech vill	smalltalk.user.misses_agent	Editorial.SmallTalk
Ech hunn dech verm�sst	smalltalk.user.misses_agent	Editorial.SmallTalk
Ech hunn dech verpasst	smalltalk.user.misses_agent	Editorial.SmallTalk
wat soll ech doriwwer maachen	smalltalk.user.needs_advice	Editorial.SmallTalk
all Virschl�i	smalltalk.user.needs_advice	Editorial.SmallTalk
wat recommand�ieren Dir	smalltalk.user.needs_advice	Editorial.SmallTalk
gitt mir e schlau Rot	smalltalk.user.needs_advice	Editorial.SmallTalk
Ech brauch Rot	smalltalk.user.needs_advice	Editorial.SmallTalk
all Rotschl�i	smalltalk.user.needs_advice	Editorial.SmallTalk
hues du eng Rotschl�i fir mech	smalltalk.user.needs_advice	Editorial.SmallTalk
berode mech	smalltalk.user.needs_advice	Editorial.SmallTalk
wat sollt ech maachen	smalltalk.user.needs_advice	Editorial.SmallTalk
kann ech fir �r Rot froen	smalltalk.user.needs_advice	Editorial.SmallTalk
k�nnt Dir mir beroden	smalltalk.user.needs_advice	Editorial.SmallTalk
guid�ieren mech	smalltalk.user.needs_advice	Editorial.SmallTalk
k�nnt Dir mir Rotschl�i ginn	smalltalk.user.needs_advice	Editorial.SmallTalk
k�nnt Dir all Rot bidden	smalltalk.user.needs_advice	Editorial.SmallTalk
ginn mir e puer Rotschl�i iwwer	smalltalk.user.needs_advice	Editorial.SmallTalk
g�ff mir gutt Rotschl�i	smalltalk.user.needs_advice	Editorial.SmallTalk
H�llef mir mat Rot	smalltalk.user.needs_advice	Editorial.SmallTalk
Ech k�int e puer Rotschl�i benotzen	smalltalk.user.needs_advice	Editorial.SmallTalk
Ech brauch e Rot vun Iech	smalltalk.user.needs_advice	Editorial.SmallTalk
Ech sichen �re Rot	smalltalk.user.needs_advice	Editorial.SmallTalk
wat k�nnt Dir recommand�ieren	smalltalk.user.needs_advice	Editorial.SmallTalk
wat propos�ieren Dir	smalltalk.user.needs_advice	Editorial.SmallTalk
wat ass �re Rot	smalltalk.user.needs_advice	Editorial.SmallTalk
Ech sinn traureg	smalltalk.user.sad	Editorial.SmallTalk
Ech traueren	smalltalk.user.sad	Editorial.SmallTalk
Ech sinn deprim�iert	smalltalk.user.sad	Editorial.SmallTalk
Ech fille mech traureg	smalltalk.user.sad	Editorial.SmallTalk
Ech sinn opgeregt	smalltalk.user.sad	Editorial.SmallTalk
Ech sinn ongl�cklech	smalltalk.user.sad	Editorial.SmallTalk
Ech hunn e schlechten Dag	smalltalk.user.sad	Editorial.SmallTalk
Ech w�ll kr�ischen	smalltalk.user.sad	Editorial.SmallTalk
Ech sinn net frou	smalltalk.user.sad	Editorial.SmallTalk
Ech schlofen	smalltalk.user.sleepy	Editorial.SmallTalk
Ech w�ll schlofen	smalltalk.user.sleepy	Editorial.SmallTalk
Ech schlofen	smalltalk.user.sleepy	Editorial.SmallTalk
Ech schlofen op de Been	smalltalk.user.sleepy	Editorial.SmallTalk
Ech schlofen	smalltalk.user.sleepy	Editorial.SmallTalk
testen	smalltalk.user.testing_agent	Editorial.SmallTalk
Ech testen dech	smalltalk.user.testing_agent	Editorial.SmallTalk
kann ech dech testen	smalltalk.user.testing_agent	Editorial.SmallTalk
Ech w�ll dech testen	smalltalk.user.testing_agent	Editorial.SmallTalk
just testen dech	smalltalk.user.testing_agent	Editorial.SmallTalk
loosst mech dech testen	smalltalk.user.testing_agent	Editorial.SmallTalk
chatbot testen	smalltalk.user.testing_agent	Editorial.SmallTalk
testen	smalltalk.user.testing_agent	Editorial.SmallTalk
Ech sinn drain�iert	smalltalk.user.tired	Editorial.SmallTalk
Ech hunn iwwerschafft	smalltalk.user.tired	Editorial.SmallTalk
Ech sinn midd	smalltalk.user.tired	Editorial.SmallTalk
Ech sinn ersch�pft	smalltalk.user.tired	Editorial.SmallTalk
Ech ginn midd	smalltalk.user.tired	Editorial.SmallTalk
Ech sinn ausgesinn	smalltalk.user.tired	Editorial.SmallTalk
Ech ginn midd	smalltalk.user.tired	Editorial.SmallTalk
Ech fille mech midd	smalltalk.user.tired	Editorial.SmallTalk
Ech warden	smalltalk.user.waits	Editorial.SmallTalk
nach �mmer waarden	smalltalk.user.waits	Editorial.SmallTalk
Ech w�rt waarden	smalltalk.user.waits	Editorial.SmallTalk
Ech kann net m�i waarden	smalltalk.user.waits	Editorial.SmallTalk
w�i laang muss ech waarden	smalltalk.user.waits	Editorial.SmallTalk
Ech g�if dech g�r er�m gesinn	smalltalk.user.wants_to_see_agent_again	Editorial.SmallTalk
Ech hoffen dech er�m ze gesinn	smalltalk.user.wants_to_see_agent_again	Editorial.SmallTalk
wier sch�in dech er�m ze gesinn	smalltalk.user.wants_to_see_agent_again	Editorial.SmallTalk
dat wier super dech er�m ze gesinn	smalltalk.user.wants_to_see_agent_again	Editorial.SmallTalk
Ech wier frou dech er�m ze gesinn	smalltalk.user.wants_to_see_agent_again	Editorial.SmallTalk
ech w�ert dech verm�ssen	smalltalk.user.wants_to_see_agent_again	Editorial.SmallTalk
kann ech dech er�m gesinn	smalltalk.user.wants_to_see_agent_again	Editorial.SmallTalk
Ech w�ll just schw�tzen	smalltalk.user.wants_to_talk	Editorial.SmallTalk
loosst eis eppes diskut�ieren	smalltalk.user.wants_to_talk	Editorial.SmallTalk
loosst eis eng Diskussioun hunn	smalltalk.user.wants_to_talk	Editorial.SmallTalk
kann ech schw�tzen	smalltalk.user.wants_to_talk	Editorial.SmallTalk
kann ech uf�nken ze schw�tzen	smalltalk.user.wants_to_talk	Editorial.SmallTalk
K�nne mir schw�tzen	smalltalk.user.wants_to_talk	Editorial.SmallTalk
Looss eis schw�tzen	smalltalk.user.wants_to_talk	Editorial.SmallTalk
ech w�ll mat dir schw�tzen	smalltalk.user.wants_to_talk	Editorial.SmallTalk
Ech muss mat dir schw�tzen	smalltalk.user.wants_to_talk	Editorial.SmallTalk
Ech w�ll mat Iech schw�tzen	smalltalk.user.wants_to_talk	Editorial.SmallTalk
k�nne mir chatten	smalltalk.user.wants_to_talk	Editorial.SmallTalk
Ech kommen no engem Moment bei Iech zr�ck	smalltalk.user.will_be_back	Editorial.SmallTalk
sinn zr�ck a 5 Minutten	smalltalk.user.will_be_back	Editorial.SmallTalk
Ech kommen er�m	smalltalk.user.will_be_back	Editorial.SmallTalk
Ech verspriechen zr�ck ze kommen	smalltalk.user.will_be_back	Editorial.SmallTalk
Ech kommen zr�ck an e puer Minutten	smalltalk.user.will_be_back	Editorial.SmallTalk
W�i eng Aarbecht huet de Kevin bei SES mat Strategie gemaach?	work.ses.strategy	Editorial.Personal
Wat waren dem Kevin seng Verantwortung bei SES am Zesummenhang mat Strategie?	work.ses.strategy	Editorial.Personal
Wat huet de Kevin bei SES am Zesummenhang mat Strategie erreecht?	work.ses.strategy	Editorial.Personal
W�i eng Aarbecht huet de Kevin bei SES mat den Resultater gemaach?	work.ses.outcomes	Editorial.Personal
Wat waren dem Kevin seng Verantwortung bei SES am Zesummenhang mat Resultater?	work.ses.outcomes	Editorial.Personal
Wat huet de Kevin bei SES am Zesummenhang mat Resultater erreecht?	work.ses.outcomes	Editorial.Personal
W�i eng Aarbecht huet de Kevin bei EmailTree AI gemaach?	work.emailtree.delivery	Editorial.Personal
Wat waren dem Kevin seng Verantwortung bei EmailTree AI?	work.emailtree.delivery	Editorial.Personal
Wat huet de Kevin bei EmailTree AI erreecht?	work.emailtree.delivery	Editorial.Personal
W�i eng Aarbecht huet de Kevin bei Devoteam gemaach?	work.devoteam.transformation	Editorial.Personal
Wat waren dem Kevin seng Verantwortung bei Devoteam?	work.devoteam.transformation	Editorial.Personal
Wat huet de Kevin bei Devoteam erreecht?	work.devoteam.transformation	Editorial.Personal
War de Kevin e Beroder bei Devoteam?	work.devoteam.transformation	Editorial.Personal
Huet de Kevin als Beroder bei Devoteam geschafft?	work.devoteam.transformation	Editorial.Personal
W�i eng Aarbecht huet de Kevin bei Microsoft gemaach?	work.microsoft.engineer	Editorial.Personal
Wat waren dem Kevin seng Verantwortung bei Microsoft?	work.microsoft.engineer	Editorial.Personal
Wat huet de Kevin bei Microsoft erreecht?	work.microsoft.engineer	Editorial.Personal
W�i eng Aarbecht huet de Kevin bei MS gemaach?	work.microsoft.engineer	Editorial.Personal
Wat waren dem Kevin seng Verantwortung bei MS?	work.microsoft.engineer	Editorial.Personal
Wat huet de Kevin bei der MS erreecht?	work.microsoft.engineer	Editorial.Personal
Huet de Kevin un der AI Academy bei Microsoft geschafft?	work.microsoft.academy	Editorial.Personal
War de Kevin an der AI Academy bei Microsoft involv�iert?	work.microsoft.academy	Editorial.Personal
W�i eng Aarbecht huet de Kevin bei Deloitte gemaach?	work.deloitte.expansion	Editorial.Personal
Wat waren dem Kevin seng Verantwortung bei Deloitte?	work.deloitte.expansion	Editorial.Personal
Wat huet de Kevin bei Deloitte erreecht?	work.deloitte.expansion	Editorial.Personal
W�i eng Aarbecht huet de Kevin bei der Europ�escher Investitiounsbank gemaach?	work.eib.leader	Editorial.Personal
Wat waren dem Kevin seng Verantwortung bei der Europ�escher Investitiounsbank?	work.eib.leader	Editorial.Personal
Wat huet de Kevin bei der Europ�escher Investitiounsbank erreecht?	work.eib.leader	Editorial.Personal
W�i eng Aarbecht huet de Kevin bei PricewaterhouseCoopers gemaach?	work.pwc.engineer	Editorial.Personal
Wat waren dem Kevin seng Verantwortung bei PricewaterhouseCoopers?	work.pwc.engineer	Editorial.Personal
Wat huet de Kevin bei PricewaterhouseCoopers erreecht?	work.pwc.engineer	Editorial.Personal
W�i eng international Erfahrung huet de Kevin?	skills.international_experience	Editorial.Personal
K�nnt Dir iwwer dem Kevin seng international Erfahrung ausbauen?	skills.international_experience	Editorial.Personal
W�i huet de Kevin d'Adaptatioun un verschidden Aarbechts�mfeld bewisen?	skills.international_experience	Editorial.Personal
Op w�i eng Man�ier huet de Kevin seng international Belaaschtung gewisen?	skills.international_experience	Editorial.Personal
Beschreift dem Kevin seng Erfahrung a verschiddene L�nner ze schaffen.	skills.international_experience	Editorial.Personal
W�i eng Leedung a Gestiounsf�egkeeten huet de Kevin?	skills.leadership_and_management	Editorial.Personal
W�i huet de Kevin Leadership a senger Carri�re bewisen?	skills.leadership_and_management	Editorial.Personal
K�nnt Dir Beispiller vu Kevin seng Leadership F�egkeeten ubidden?	skills.leadership_and_management	Editorial.Personal
W�i eng Gestiounsf�egkeeten weist de Kevin aus?	skills.leadership_and_management	Editorial.Personal
Beschreift dem Kevin seng Approche fir Teams ze f�ieren.	skills.leadership_and_management	Editorial.Personal
A w�i enge Impakt Projete war de Kevin involv�iert?	skills.impactful_projects	Editorial.Personal
K�nnt Dir e puer vun de Kevin seng Notabele Projeten opzielen?	skills.impactful_projects	Editorial.Personal
W�i hunn dem Kevin seng Projeten en Impakt gemaach?	skills.impactful_projects	Editorial.Personal
Wat sinn e puer Beispiller vun den Impakt Initiativen vum Kevin?	skills.impactful_projects	Editorial.Personal
Beschreift d'Projeten d�i an der Karri�r vum Kevin instrumental waren.	skills.impactful_projects	Editorial.Personal
A w�i enge Branchen spezialis�iert de Kevin?	skills.industry_expertise	Editorial.Personal
Wat Secteuren huet Kevin Expertise an?	skills.industry_expertise	Editorial.Personal
K�nnt Dir dem Kevin seng Ber�icher vun der Industriew�ssen opl�schten?	skills.industry_expertise	Editorial.Personal
A w�i enge Ber�icher excel Kevin?	skills.industry_expertise	Editorial.Personal
Beschreift dem Kevin seng Spezialisatioun a verschiddenen Industrien.	skills.industry_expertise	Editorial.Personal
W�i priorit�r Kevin berufflech Entw�cklung?	skills.professional_development	Editorial.Personal
W�i eng Schr�tt m�cht de Kevin fir seng F�egkeeten ze verbesseren?	skills.professional_development	Editorial.Personal
K�nnt Dir iwwer dem Kevin s�in Engagement fir kontinu�ierlech L�ieren ausbauen?	skills.professional_development	Editorial.Personal
W�i eng Strategien benotzt de Kevin fir eng weider F�egkeet Entw�cklung?	skills.professional_development	Editorial.Personal
Beschreift dem Kevin seng Approche fir aktualis�iert ze bleiwen mat Industrietrends.	skills.professional_development	Editorial.Personal
A w�i enge Programm�ierungssproochen ass de Kevin beherrscht?	skills.programming_languages	Editorial.Personal
"K�nnt Dir d'Programm�ierungssprooche not�ieren, d�i de Kevin gutt kennt?"	skills.programming_languages	Editorial.Personal
W�i eng Sprooche benotzt de Kevin a senger Aarbecht?	skills.programming_languages	Editorial.Personal
Beschreift dem Kevin seng F�egkeet a verschiddene Programm�ierungssproochen.	skills.programming_languages	Editorial.Personal
A w�i enge Programm�ierungssproochen excel�iert de Kevin?	skills.programming_languages	Editorial.Personal
A w�i enge Kaderen a Biblioth�iken erlieft de Kevin?	skills.frameworks_libraries	Editorial.Personal
K�nnt Dir d'Kaderen a Biblioth�iken opl�schten wou Kevin Expertise huet?	skills.frameworks_libraries	Editorial.Personal
Beschreift dem Kevin seng F�egkeet a verschiddene Kaderen a Biblioth�iken.	skills.frameworks_libraries	Editorial.Personal
W�i eng Kaderen a Biblioth�ike benotzt de Kevin allgemeng a senge Projeten?	skills.frameworks_libraries	Editorial.Personal
A w�i enge Kaderen a Biblioth�iken weist de Kevin Expertise?	skills.frameworks_libraries	Editorial.Personal
W�i eng Datenbanken ass de Kevin qualifiz�iert?	skills.databases	Editorial.Personal
K�nnt Dir d'Datenbanken opl�schten mat deem Kevin qualifiz�iert ass?	skills.databases	Editorial.Personal
W�i eng Datenbanken benotzt de Kevin a senger Aarbecht?	skills.databases	Editorial.Personal
Beschreift dem Kevin seng Expertise a verschiddenen Datenbanken.	skills.databases	Editorial.Personal
A w�i enge Datenbanken excel�iert de Kevin?	skills.databases	Editorial.Personal
Mat w�i engem Entw�cklungsinstrumenter a Plattformen ass de Kevin erlieft?	skills.development_tools_platforms	Editorial.Personal
K�nnt Dir d'Entw�cklungstools a Plattformen opl�schten d�i Kevin benotzt?	skills.development_tools_platforms	Editorial.Personal
Beschreift dem Kevin seng Erfahrung mat verschiddenen Entw�cklungsinstrumenter a Plattformen.	skills.development_tools_platforms	Editorial.Personal
W�i eng Tools a Plattforme benotzt de Kevin allgemeng a senge Projeten?	skills.development_tools_platforms	Editorial.Personal
A w�i enge Tools a Plattformen weist de Kevin Expertise?	skills.development_tools_platforms	Editorial.Personal
Mat wat fir CI/CD Tools a Praktiken huet de Kevin Erfahrung?	skills.ci_cd	Editorial.Personal
K�nnt Dir d'CI / CD Tools opl�schte mat deem Kevin vertraut ass?	skills.ci_cd	Editorial.Personal
Beschreift dem Kevin seng Erfahrung mat CI/CD Prozesser.	skills.ci_cd	Editorial.Personal
W�i eng CI/CD Tools benotzt de Kevin allgemeng a senge Projeten?	skills.ci_cd	Editorial.Personal
A w�i enge CI/CD Praktiken weist de Kevin Expertise?	skills.ci_cd	Editorial.Personal
W�i eng Test- a Linting-Tools ass de Kevin beherrscht?	skills.testing_linting	Editorial.Personal
K�nnt Dir d'Test- a Linting-Tools opl�schten d�i Kevin benotzt?	skills.testing_linting	Editorial.Personal
Beschreift dem Kevin seng Kompetenz a verschiddenen Test- a Linting-Tools.	skills.testing_linting	Editorial.Personal
W�i eng Test- a Linting-Tools benotzt de Kevin allgemeng?	skills.testing_linting	Editorial.Personal
A w�i engem Test- a Linting-Tools weist de Kevin Expertise?	skills.testing_linting	Editorial.Personal
A w�i enge Azure Servicer huet de Kevin Expertise?	skills.cloud_platforms.azure	Editorial.Personal
"K�nnt Dir d'Azure Servicer opl�schten, d�i de Kevin kennt?"	skills.cloud_platforms.azure	Editorial.Personal
Beschreift dem Kevin seng Expertise a verschiddene Azure Servicer.	skills.cloud_platforms.azure	Editorial.Personal
W�i eng Azure Servicer benotzt de Kevin allgemeng?	skills.cloud_platforms.azure	Editorial.Personal
A w�i enge Azure Servicer weist de Kevin Expertise?	skills.cloud_platforms.azure	Editorial.Personal
"Zous�tzlech zu Azure, w�i eng aner Cloud Plattformen huet de Kevin Erfahrung mat?"	skills.cloud_platforms.other	Editorial.Personal
K�nnt Dir d�i aner Cloud Plattformen opl�schten wou de Kevin erlieft g�tt?	skills.cloud_platforms.other	Editorial.Personal
Beschreift dem Kevin seng Erfahrung mat anere Cloud Plattformen nieft Azure.	skills.cloud_platforms.other	Editorial.Personal
W�i eng aner Cloud Plattformen benotzt Kevin allgemeng?	skills.cloud_platforms.other	Editorial.Personal
A w�i enge aner Cloud Plattformen weist de Kevin Expertise?	skills.cloud_platforms.other	Editorial.Personal
W�i eng Planungs- an Designinstrumenter ass de Kevin beherrscht?	skills.planning_design	Editorial.Personal
K�nnt Dir d'Planungs- an Designtools opl�schten d�i Kevin benotzt?	skills.planning_design	Editorial.Personal
Beschreift dem Kevin seng F�egkeet a verschiddene Planungs- an Designinstrumenter.	skills.planning_design	Editorial.Personal
W�i eng Planungs- an Designinstrumenter benotzt de Kevin allgemeng?	skills.planning_design	Editorial.Personal
A w�i eng Planungs- an Designinstrumenter weist de Kevin Expertise?	skills.planning_design	Editorial.Personal
W�i eng Zertifiz�ierungen h�lt de Kevin am Zesummenhang mat Azure?	certifications.azure	Editorial.Personal
K�nnt Dir dem Kevin seng Azure-verbonne Zertifiz�ierungen opl�schten?	certifications.azure	Editorial.Personal
Beschreift dem Kevin seng Zertifiz�ierungen an Azure.	certifications.azure	Editorial.Personal
W�i eng Azure Zertifiz�ierungen huet de Kevin kritt?	certifications.azure	Editorial.Personal
A w�i enge Azure Zertifiz�ierungen huet de Kevin Expertise?	certifications.azure	Editorial.Personal
W�i eng Zertifiz�ierungen huet de Kevin am Deep Learning ofgeschloss?	certifications.deep_learning	Editorial.Personal
K�nnt Dir dem Kevin seng Zertifiz�ierungen am Deep Learning opl�schten?	certifications.deep_learning	Editorial.Personal
Beschreift dem Kevin seng Zertifiz�ierungen am Zesummenhang mat Deep Learning.	certifications.deep_learning	Editorial.Personal
W�i eng Deep Learning Zertifiz�ierungen huet de Kevin kritt?	certifications.deep_learning	Editorial.Personal
A w�i enge Deep Learning Zertifiz�ierungen huet de Kevin Expertise?	certifications.deep_learning	Editorial.Personal
W�i ee Programm huet de Kevin um MIT ofgeschloss?	certifications.mit	Editorial.Personal
K�nnt Dir de Programm de Kevin op MIT ofgeschloss hunn?	certifications.mit	Editorial.Personal
Beschreift dem Kevin seng F�erdegstellung vum New Space Economy Programm um MIT.	certifications.mit	Editorial.Personal
A w�i engem Programm huet de Kevin um MIT deelgeholl?	certifications.mit	Editorial.Personal
A w�i engem Programm um MIT h�lt de Kevin Unerkennung?	certifications.mit	Editorial.Personal
Wou krut de Kevin fortgeschratt Verst�ndnis vum Weltraumsecteur?	education.mit	Editorial.Personal
K�nnt Dir iwwer dem Kevin seng Ausbildung am Weltraumsecteur ausbauen?	education.mit	Editorial.Personal
Beschreift dem Kevin seng fortgeschratt Verst�ndnis vum Weltraumsektor vum MIT.	education.mit	Editorial.Personal
Wat huet de Kevin um MIT am Zesummenhang mam Weltraumsektor stud�iert?	education.mit	Editorial.Personal
A w�i engem Programm um MIT huet de Kevin Expertise am Weltraumsecteur gewonnen?	education.mit	Editorial.Personal
Aus w�i engem College huet de Kevin Diplom gemaach?	education.tci_college	Editorial.Personal
K�nnt Dir de College aus deem de Kevin Diplom gemaach huet?	education.tci_college	Editorial.Personal
Wi eng Leeschtungen huet de Kevin um Wolves Summit 2021 verdngt?	awards.recognition	Editorial.Personal
Wi eng Auszeechnunge krut de Kevin fir seng Bitrg zu der Devoteam AI Academy?	awards.recognition	Editorial.Personal
Wi eng Unerkennungen huet de Kevin kritt?	awards.recognition	Editorial.Personal
Wi eng Notabele Concoursen oder Auszeechnunge hunn de Kevin gewonnen?	awards.recognition	Editorial.Personal
Wi eng Bedeelegung huet de Kevin an der Promotioun vun der AI Bewosstsinn?	interviews.participation	Editorial.Personal
Wou huet de Kevin als Spriecher matgemaach?	interviews.participation	Editorial.Personal
Wat bemierkenswert Eventer huet de Kevin bigedroen betreffend AI Ausbildung?	interviews.participation	Editorial.Personal
Wi gouf de Kevin am Berich vun der knschtlecher Intelligenz unerkannt?	interviews.participation	Editorial.Personal